x,y,n,e,s,w,sx,sy,gx,gy
0,15,1,0,0,1,0,0,7,7
1,15,1,0,1,0,0,0,7,7
2,15,1,0,1,0,0,0,7,7
3,15,1,0,0,0,0,0,7,7
4,15,1,0,1,0,0,0,7,7
5,15,1,0,1,0,0,0,7,7
6,15,1,1,0,0,0,0,7,7
7,15,1,1,1,1,0,0,7,7
8,15,1,1,1,1,0,0,7,7
9,15,1,0,0,1,0,0,7,7
10,15,1,0,1,0,0,0,7,7
11,15,1,0,1,0,0,0,7,7
12,15,1,0,0,0,0,0,7,7
13,15,1,0,1,0,0,0,7,7
14,15,1,0,1,0,0,0,7,7
15,15,1,1,0,0,0,0,7,7
0,14,0,1,0,1,0,0,7,7
1,14,1,1,1,1,0,0,7,7
2,14,1,0,0,1,0,0,7,7
3,14,0,1,0,0,0,0,7,7
4,14,1,1,1,1,0,0,7,7
5,14,1,1,1,1,0,0,7,7
6,14,0,0,1,1,0,0,7,7
7,14,1,0,1,0,0,0,7,7
8,14,1,0,1,0,0,0,7,7
9,14,0,1,1,0,0,0,7,7
10,14,1,1,1,1,0,0,7,7
11,14,1,1,1,1,0,0,7,7
12,14,0,1,0,1,0,0,7,7
13,14,1,1,1,1,0,0,7,7
14,14,1,1,1,1,0,0,7,7
15,14,0,1,0,1,0,0,7,7
0,13,0,1,0,1,0,0,7,7
1,13,1,0,0,1,0,0,7,7
2,13,0,1,1,0,0,0,7,7
3,13,0,1,0,1,0,0,7,7
4,13,1,1,1,1,0,0,7,7
5,13,1,1,1,1,0,0,7,7
6,13,1,0,0,1,0,0,7,7
7,13,1,1,0,0,0,0,7,7
8,13,1,0,0,1,0,0,7,7
9,13,1,0,1,0,0,0,7,7
10,13,1,0,1,0,0,0,7,7
11,13,1,1,0,0,0,0,7,7
12,13,0,1,0,1,0,0,7,7
13,13,1,1,1,1,0,0,7,7
14,13,1,1,1,1,0,0,7,7
15,13,0,1,0,1,0,0,7,7
0,12,0,0,0,1,0,0,7,7
1,12,0,0,1,0,0,0,7,7
2,12,1,0,1,0,0,0,7,7
3,12,0,1,0,0,0,0,7,7
4,12,1,1,1,1,0,0,7,7
5,12,1,1,1,1,0,0,7,7
6,12,0,1,0,1,0,0,7,7
7,12,0,1,0,1,0,0,7,7
8,12,0,1,0,1,0,0,7,7
9,12,1,0,0,1,0,0,7,7
10,12,1,0,1,0,0,0,7,7
11,12,0,1,1,0,0,0,7,7
12,12,0,0,0,1,0,0,7,7
13,12,1,0,1,0,0,0,7,7
14,12,1,0,1,0,0,0,7,7
15,12,0,1,0,0,0,0,7,7
0,11,0,1,0,1,0,0,7,7
1,11,1,1,1,1,0,0,7,7
2,11,1,1,1,1,0,0,7,7
3,11,0,0,1,1,0,0,7,7
4,11,1,0,1,0,0,0,7,7
5,11,1,1,0,0,0,0,7,7
6,11,0,1,0,1,0,0,7,7
7,11,0,1,0,1,0,0,7,7
8,11,0,1,0,1,0,0,7,7
9,11,0,1,0,1,0,0,7,7
10,11,1,0,0,1,0,0,7,7
11,11,1,0,1,0,0,0,7,7
12,11,0,1,1,0,0,0,7,7
13,11,1,0,0,1,0,0,7,7
14,11,1,1,0,0,0,0,7,7
15,11,0,1,0,1,0,0,7,7
0,10,0,1,1,1,0,0,7,7
1,10,1,1,1,1,0,0,7,7
2,10,1,1,1,1,0,0,7,7
3,10,1,1,1,1,0,0,7,7
4,10,1,1,1,1,0,0,7,7
5,10,0,0,0,1,0,0,7,7
6,10,0,1,1,0,0,0,7,7
7,10,0,0,1,1,0,0,7,7
8,10,0,1,1,0,0,0,7,7
9,10,0,0,1,1,0,0,7,7
10,10,0,1,0,0,0,0,7,7
11,10,1,1,1,1,0,0,7,7
12,10,1,1,1,1,0,0,7,7
13,10,0,1,0,1,0,0,7,7
14,10,0,1,0,1,0,0,7,7
15,10,0,1,0,1,0,0,7,7
0,9,1,0,0,1,0,0,7,7
1,9,1,1,0,0,0,0,7,7
2,9,1,0,0,1,0,0,7,7
3,9,1,0,1,0,0,0,7,7
4,9,1,0,1,0,0,0,7,7
5,9,0,1,1,0,0,0,7,7
6,9,1,0,0,1,0,0,7,7
7,9,1,0,1,0,0,0,7,7
8,9,1,0,1,0,0,0,7,7
9,9,1,1,0,0,0,0,7,7
10,9,0,0,1,1,0,0,7,7
11,9,1,0,0,0,0,0,7,7
12,9,1,0,1,0,0,0,7,7
13,9,0,1,0,0,0,0,7,7
14,9,0,0,0,1,0,0,7,7
15,9,0,1,1,0,0,0,7,7
0,8,0,1,0,1,0,0,7,7
1,8,0,1,0,1,0,0,7,7
2,8,0,1,0,1,0,0,7,7
3,8,1,1,1,1,0,0,7,7
4,8,1,1,1,1,0,0,7,7
5,8,1,1,1,1,0,0,7,7
6,8,0,0,0,1,0,0,7,7
7,8,1,0,0,0,0,0,7,7
8,8,1,1,0,0,0,0,7,7
9,8,0,1,0,1,0,0,7,7
10,8,1,0,1,1,0,0,7,7
11,8,0,0,1,0,0,0,7,7
12,8,1,1,0,0,0,0,7,7
13,8,0,1,0,1,0,0,7,7
14,8,0,1,0,1,0,0,7,7
15,8,1,1,1,1,0,0,7,7
0,7,0,1,0,1,0,0,7,7
1,7,0,1,0,1,0,0,7,7
2,7,0,1,1,1,0,0,7,7
3,7,1,1,1,1,0,0,7,7
4,7,1,1,1,1,0,0,7,7
5,7,1,1,1,1,0,0,7,7
6,7,0,1,0,1,0,0,7,7
7,7,0,0,1,1,0,0,7,7
8,7,0,1,1,0,0,0,7,7
9,7,0,0,0,1,0,0,7,7
10,7,1,0,1,0,0,0,7,7
11,7,1,0,1,0,0,0,7,7
12,7,0,1,1,0,0,0,7,7
13,7,0,1,0,1,0,0,7,7
14,7,0,1,0,1,0,0,7,7
15,7,1,1,1,1,0,0,7,7
0,6,0,1,0,1,0,0,7,7
1,6,0,0,0,1,0,0,7,7
2,6,1,0,1,0,0,0,7,7
3,6,1,0,0,0,0,0,7,7
4,6,1,0,1,0,0,0,7,7
5,6,1,1,0,0,0,0,7,7
6,6,0,0,1,1,0,0,7,7
7,6,1,0,1,0,0,0,7,7
8,6,1,0,1,0,0,0,7,7
9,6,0,1,1,0,0,0,7,7
10,6,1,0,1,1,0,0,7,7
11,6,1,0,1,0,0,0,7,7
12,6,1,0,1,0,0,0,7,7
13,6,0,1,1,0,0,0,7,7
14,6,0,0,1,1,0,0,7,7
15,6,1,1,0,0,0,0,7,7
0,5,0,1,0,1,0,0,7,7
1,5,0,1,1,1,0,0,7,7
2,5,1,0,0,1,0,0,7,7
3,5,0,1,1,0,0,0,7,7
4,5,1,1,1,1,0,0,7,7
5,5,0,1,0,1,0,0,7,7
6,5,1,1,0,1,0,0,7,7
7,5,1,1,1,1,0,0,7,7
8,5,1,1,1,1,0,0,7,7
9,5,1,0,0,1,0,0,7,7
10,5,1,1,0,0,0,0,7,7
11,5,1,1,1,1,0,0,7,7
12,5,1,1,1,1,0,0,7,7
13,5,1,1,1,1,0,0,7,7
14,5,1,1,1,1,0,0,7,7
15,5,0,1,0,1,0,0,7,7
0,4,0,1,0,1,0,0,7,7
1,4,1,0,0,1,0,0,7,7
2,4,0,1,1,0,0,0,7,7
3,4,1,0,1,1,0,0,7,7
4,4,1,1,1,0,0,0,7,7
5,4,0,1,0,1,0,0,7,7
6,4,0,1,0,1,0,0,7,7
7,4,1,1,1,1,0,0,7,7
8,4,1,1,1,1,0,0,7,7
9,4,0,1,0,1,0,0,7,7
10,4,0,0,1,1,0,0,7,7
11,4,1,0,1,0,0,0,7,7
12,4,1,1,0,0,0,0,7,7
13,4,1,1,1,1,0,0,7,7
14,4,1,1,1,1,0,0,7,7
15,4,0,1,0,1,0,0,7,7
0,3,0,0,0,1,0,0,7,7
1,3,0,1,1,0,0,0,7,7
2,3,1,0,0,1,0,0,7,7
3,3,1,0,1,0,0,0,7,7
4,3,1,0,1,0,0,0,7,7
5,3,0,1,1,0,0,0,7,7
6,3,0,1,0,1,0,0,7,7
7,3,1,1,1,1,0,0,7,7
8,3,1,1,1,1,0,0,7,7
9,3,0,1,0,1,0,0,7,7
10,3,1,1,1,1,0,0,7,7
11,3,1,1,1,1,0,0,7,7
12,3,0,0,0,1,0,0,7,7
13,3,1,0,1,0,0,0,7,7
14,3,1,0,1,0,0,0,7,7
15,3,0,1,0,0,0,0,7,7
0,2,0,1,0,1,0,0,7,7
1,2,1,1,0,1,0,0,7,7
2,2,0,1,0,1,0,0,7,7
3,2,1,1,1,1,0,0,7,7
4,2,1,1,1,1,0,0,7,7
5,2,1,1,1,1,0,0,7,7
6,2,0,0,1,1,0,0,7,7
7,2,1,0,1,0,0,0,7,7
8,2,1,0,1,0,0,0,7,7
9,2,0,1,1,0,0,0,7,7
10,2,1,1,1,1,0,0,7,7
11,2,1,1,1,1,0,0,7,7
12,2,0,1,0,1,0,0,7,7
13,2,1,1,1,1,0,0,7,7
14,2,1,1,1,1,0,0,7,7
15,2,0,1,0,1,0,0,7,7
0,1,0,1,0,1,0,0,7,7
1,1,0,1,0,1,0,0,7,7
2,1,0,1,0,1,0,0,7,7
3,1,1,0,1,1,0,0,7,7
4,1,1,0,1,0,0,0,7,7
5,1,1,0,0,0,0,0,7,7
6,1,1,0,1,0,0,0,7,7
7,1,1,0,0,0,0,0,7,7
8,1,1,0,1,0,0,0,7,7
9,1,1,1,0,0,0,0,7,7
10,1,1,1,1,1,0,0,7,7
11,1,1,1,1,1,0,0,7,7
12,1,0,1,0,1,0,0,7,7
13,1,1,1,1,1,0,0,7,7
14,1,1,1,1,1,0,0,7,7
15,1,0,1,0,1,0,0,7,7
0,0,0,1,1,1,0,0,7,7
1,0,0,1,1,1,0,0,7,7
2,0,0,0,1,1,0,0,7,7
3,0,1,0,1,0,0,0,7,7
4,0,1,0,1,0,0,0,7,7
5,0,0,0,1,0,0,0,7,7
6,0,1,0,1,0,0,0,7,7
7,0,0,1,1,0,0,0,7,7
8,0,1,1,1,1,0,0,7,7
9,0,0,0,1,1,0,0,7,7
10,0,1,0,1,0,0,0,7,7
11,0,1,0,1,0,0,0,7,7
12,0,0,0,1,0,0,0,7,7
13,0,1,0,1,0,0,0,7,7
14,0,1,0,1,0,0,0,7,7
15,0,0,1,1,0,0,0,7,7
