9 7 b b 9 3 9 3 9 3 d 5 5 3 d 3 
8 5 2 8 6 c 6 c 6 c 1 3 9 2 b a 
8 7 c 2 d 1 7 9 3 9 6 a a 8 0 6 
8 7 d 4 1 4 3 a 8 4 7 8 6 a 8 7 
c 1 5 1 4 3 c 6 8 7 9 6 d 2 8 3 
d 2 d 6 d 6 9 5 6 b c 3 9 6 a a 
b 8 7 9 5 5 6 d 7 8 5 4 0 1 4 6 
8 2 b 8 3 f b 9 1 0 5 7 a 8 5 3 
a e c 2 a b a c 6 a 9 3 a e d 2 
8 5 1 0 6 a 8 3 d 6 e 8 4 5 3 a 
a 9 6 c 3 a c 4 7 d 7 a d 5 6 a 
8 4 3 9 6 a b 9 5 5 3 a b d 1 6 
8 7 a c 3 a a c 3 9 6 a a 9 4 3 
8 5 2 9 6 a a 9 2 a d 6 8 4 3 a 
8 3 c 4 7 e 8 6 a 8 5 1 4 7 8 6 
e c 5 5 5 5 6 d 4 6 d 6 d 5 4 7 
