9 5 5 5 5 5 5 5 5 5 5 5 5 5 5 3 
c 5 5 5 5 5 5 5 5 5 5 5 5 5 3 a 
9 3 9 3 9 3 b 9 5 3 b b 9 3 a a 
a c 6 c 6 c 2 c 1 0 0 4 6 a a a 
a b 9 3 9 3 a 9 6 a c 7 9 6 a a 
a 8 2 c 6 c 6 a d 4 3 9 6 b a a 
a a e 9 5 5 5 4 7 9 6 c 3 a a a 
a a 9 6 9 3 b 9 1 6 9 1 6 8 2 a 
a 8 6 9 6 8 2 c 6 b a c 3 e a a 
a e 9 6 9 2 8 3 d 2 a 9 4 3 a a 
a 9 6 9 6 e a c 3 c 2 c 5 0 2 a 
8 6 b c 1 3 c 3 c 3 c 5 3 e e a 
8 1 2 9 2 8 7 8 3 c 3 b c 5 3 a 
a a 8 2 c 6 b e c 3 c 2 b b a a 
a a e c 1 5 0 5 1 4 3 c 4 4 6 a 
e c 5 5 4 5 4 5 4 5 4 5 5 5 5 6 
