9 5 1 1 5 1 3 9 3 9 5 5 1 1 5 3 
a 9 2 c 5 6 c 2 c 6 9 1 6 c 3 a 
8 6 c 5 1 3 9 6 9 1 6 c 3 9 6 a 
8 3 9 1 6 c 2 9 6 c 3 9 6 8 1 6 
a 8 6 c 3 9 6 c 3 9 2 8 5 6 c 3 
c 4 3 9 6 c 3 9 4 6 c 4 5 3 9 2 
9 1 6 c 1 1 6 c 5 3 9 5 5 6 a a 
a 8 3 9 6 c 3 9 1 4 6 9 3 9 2 a 
8 6 c 4 3 9 2 c 6 9 1 6 c 6 c 2 
8 3 9 1 4 6 c 3 9 6 c 3 9 3 9 6 
a 8 6 c 1 3 9 2 8 3 9 4 6 c 4 3 
a 8 3 9 6 c 2 8 6 c 4 1 3 9 1 6 
8 6 c 4 3 9 6 c 3 9 1 6 c 6 c 3 
8 3 9 5 2 8 3 9 4 6 c 3 9 1 1 2 
a 8 6 9 4 2 c 4 5 3 9 4 2 e e a 
e c 5 4 5 4 5 5 5 4 4 5 4 5 5 6 
