b d 5 1 5 3 9 5 5 1 5 5 5 5 5 3 
8 5 3 a 9 6 8 3 9 4 5 5 5 1 3 a 
8 3 a a a d 2 a 8 5 1 3 9 6 c 2 
e a c 2 c 3 e a 8 5 2 8 4 7 9 2 
9 2 b a 9 2 9 2 8 5 0 4 7 9 6 a 
a e 8 2 a 8 2 a a 9 4 7 9 6 9 2 
8 3 e a c 6 e e 8 4 7 9 6 9 6 a 
e c 3 c 1 5 3 9 2 b 9 4 5 0 5 6 
9 3 c 3 c 1 2 c 6 c 4 5 3 e 9 3 
a c 3 8 7 e 8 3 9 5 1 1 4 7 a a 
c 5 4 2 9 3 e a a 9 2 a 9 5 6 a 
9 5 5 2 a 8 5 6 c 2 c 0 4 1 3 a 
8 5 1 6 a a b b b c 3 c 5 2 e a 
8 3 a 9 2 8 0 0 0 3 c 3 d 6 9 2 
a a c 6 c 6 e e a c 3 c 5 5 6 a 
e c 5 5 5 5 5 5 4 5 4 5 5 5 5 6 
