9 5 5 5 5 5 5 5 5 5 5 5 5 5 5 3 
a 9 5 5 1 5 1 5 1 5 1 5 1 5 3 a 
a 8 3 9 6 b c 3 8 1 4 1 4 3 a a 
a a 8 2 9 6 d 0 2 c 1 4 1 4 2 a 
a a a 8 0 5 3 a c 1 4 1 4 3 a a 
a 8 2 e 8 3 a c 5 4 1 4 3 8 2 a 
a a c 1 6 c 0 5 7 d 4 3 8 2 a a 
a c 5 4 5 5 4 1 3 9 3 8 2 8 2 a 
a 9 3 9 3 9 3 c 6 a 8 2 c 2 a a 
a a a a a a a 9 3 8 2 8 3 8 2 a 
a a a a a a a a 8 2 8 2 8 2 a a 
a a a a a a a 8 2 8 2 8 2 8 2 a 
a a c 6 c 6 c 6 c 6 c 6 c 6 a a 
a a 9 3 9 3 9 1 3 b 9 1 3 b a a 
a 8 6 c 6 c 6 e c 4 6 e c 4 6 a 
e c 5 5 5 5 5 5 5 5 5 5 5 5 5 6 
