9 5 5 5 5 5 5 5 5 5 5 5 5 5 1 3 
8 7 9 3 d 1 5 5 5 5 5 5 5 3 e a 
a d 2 c 3 c 5 5 5 5 5 3 d 4 5 2 
a b 8 7 a b 9 5 3 b 9 4 5 3 d 6 
a c 2 d 2 8 6 b c 4 6 b d 6 9 7 
a b 8 7 8 6 9 2 9 1 7 c 5 1 4 3 
a c 2 d 6 9 6 c 6 c 1 7 9 4 1 2 
8 3 c 3 d 0 3 9 3 9 2 9 6 9 6 e 
a a b 8 3 a e 8 6 e a a 9 4 5 7 
a 8 2 e a 8 7 a b 9 2 a c 5 5 3 
a e c 3 a c 3 c 0 2 e a 9 5 5 6 
a b 9 6 8 3 c 3 e e 9 2 c 1 5 3 
a 8 6 b e a d 0 7 b a e b c 3 a 
a c 3 c 5 2 d 0 7 8 6 9 4 5 4 2 
a 9 6 9 3 c 5 4 5 4 7 e 9 3 b a 
e c 5 6 c 5 5 5 5 5 5 5 6 c 4 6 
