9 1 5 5 5 5 5 5 5 5 1 3 9 5 5 3 
a a 9 3 9 3 9 3 9 3 a a a d 3 a 
a c 6 c 6 c 6 c 6 a a a c 5 6 a 
a 9 5 5 5 5 5 5 5 6 e c 1 5 5 6 
a a 9 5 5 5 5 5 3 d 5 1 4 5 5 3 
a a a 9 5 5 5 5 6 d 1 4 5 5 3 a 
a a a c 5 5 1 7 d 1 4 7 9 5 6 a 
a a a 9 5 3 a 9 3 c 3 d 4 5 5 2 
a a c 6 9 6 c 4 6 9 6 9 5 5 3 a 
a c 5 5 4 5 5 1 5 6 d 4 5 3 a a 
c 1 5 3 9 5 3 c 5 5 5 5 5 6 a a 
9 4 3 a c 5 2 d 5 5 5 5 5 3 a a 
8 1 6 c 5 5 2 9 5 5 5 5 5 2 a a 
a a 9 5 5 5 6 c 5 5 5 5 3 a a a 
a a c 5 5 5 5 5 5 5 5 5 6 c 6 a 
e c 5 5 5 5 5 5 5 5 5 5 5 5 5 6 
