b 9 5 3 d 5 1 5 5 5 1 5 5 5 1 7 
8 0 5 0 5 5 0 5 5 7 a d 5 1 0 3 
a c 7 e 9 5 4 5 5 3 a 9 5 2 a a 
a 9 5 3 c 5 5 5 5 6 e a d 2 a a 
a a b a 9 1 1 1 1 1 1 0 7 e e a 
a a a a a a a a a e e a d 5 5 2 
a c 6 a a a a e e d 5 2 9 3 b a 
c 5 5 2 a a e 9 3 d 5 2 a a a a 
9 1 3 a a a 9 4 6 d 5 2 a a a a 
a a a a a a 8 5 5 5 5 2 a 8 0 2 
a a e a a e 8 5 5 5 5 2 a a a a 
a c 5 6 c 5 4 5 5 5 5 6 c 6 a e 
8 5 5 3 9 5 5 5 1 5 5 5 3 d 0 3 
8 5 3 a a d 5 3 a 9 5 7 a b a a 
8 3 a a c 5 5 2 a c 5 5 6 c 2 e 
e c 4 4 5 5 5 6 c 5 5 5 5 5 4 7 
