9 1 1 1 1 1 1 1 1 1 1 1 1 1 1 3 
8 0 0 0 0 0 0 0 0 0 0 0 0 0 0 2 
8 0 0 0 0 0 0 0 0 0 0 0 0 0 0 2 
8 0 0 0 0 0 0 0 0 0 0 0 0 0 0 2 
8 0 0 0 0 0 0 0 0 0 0 0 0 0 0 2 
8 0 0 0 0 0 0 0 0 0 0 0 0 0 0 2 
8 0 0 0 0 0 0 0 0 0 0 0 0 0 0 2 
8 0 0 0 0 0 0 0 0 0 0 0 0 0 0 2 
8 0 0 0 0 0 0 0 0 0 0 0 0 0 0 2 
8 0 0 0 0 0 0 0 0 0 0 0 0 0 0 2 
c 4 4 4 4 4 4 4 4 4 0 0 0 0 0 2 
9 1 1 1 1 1 1 1 1 3 8 0 0 0 0 2 
8 0 0 0 0 0 0 0 0 2 8 0 0 0 0 2 
8 0 0 0 0 0 0 0 0 2 8 0 0 0 0 2 
8 0 0 0 0 0 0 0 0 2 8 0 0 0 0 2 
e c 4 4 4 4 4 4 4 6 c 4 4 4 4 6 
