9 5 5 5 5 3 9 5 5 1 3 9 1 5 3 b 
a 9 5 5 3 c 6 9 3 e 8 2 8 5 2 a 
a c 5 3 a 9 5 2 c 5 2 c 2 b c 2 
c 1 5 2 a c 3 e 9 3 8 7 8 4 3 a 
b e b e 8 7 8 5 2 8 6 9 6 9 6 a 
8 1 4 5 4 7 e d 6 a 9 6 9 6 9 6 
a a b d 5 5 5 5 5 0 6 9 6 9 4 3 
a e 8 3 9 3 9 1 3 e 9 6 9 6 b a 
c 3 a c 6 c 6 c 6 b c 5 4 3 c 2 
9 6 a d 5 1 5 5 5 4 3 d 5 2 d 2 
a d 4 5 5 6 9 7 9 7 c 5 5 4 7 a 
a b d 5 5 1 6 d 2 b d 5 1 5 5 2 
8 4 7 9 1 2 9 5 2 a 9 1 0 5 1 2 
8 5 3 a a 8 6 f c 2 a a a 9 6 a 
a b a e a a f b f a e a 8 6 9 2 
e c 4 5 6 c 5 4 5 4 5 4 4 5 6 e 
