d 1 1 1 1 1 5 1 1 3 b 9 3 9 7 b 
d 2 a a a a 9 6 e c 4 6 a 8 7 a 
d 4 4 2 a a c 7 9 1 1 3 a c 3 a 
9 5 1 0 2 a b b a a a a a d 2 a 
8 3 a a a 8 4 2 a 8 4 2 a d 2 a 
a 8 0 4 0 4 5 6 c 4 3 c 6 d 2 a 
a a a 9 4 5 5 1 5 7 e 9 3 b a a 
8 0 0 0 1 1 7 8 3 9 5 2 c 2 a a 
a a a a a c 7 c 6 a d 0 1 2 a a 
a 8 0 0 0 1 5 1 5 4 7 a a a a a 
a a a a a e d 4 5 5 5 0 4 4 2 a 
a a a a c 5 5 5 5 5 5 4 5 5 6 a 
a a a a 9 5 5 5 5 5 1 5 5 5 5 2 
a a a 8 2 9 3 b 9 1 4 1 5 5 5 6 
a a a a c 2 8 2 a 8 5 0 1 5 5 3 
e e c 4 5 6 e c 4 4 5 6 c 5 5 6 
