9 5 3 9 5 5 5 5 5 5 5 5 5 5 5 3 
a b a c 1 1 7 9 1 5 5 5 5 5 3 a 
a 8 6 b e a 9 2 8 7 9 5 1 7 a a 
a a 9 6 9 6 a 8 0 3 c 3 c 3 a a 
a a a 9 6 9 6 a a c 3 c 3 a c 6 
a a 8 2 9 2 d 2 8 7 8 1 2 a 9 3 
a a a e a a 9 4 4 3 a e e a a a 
a a a b a a c 1 1 6 a 9 3 a a a 
a a a a a c 3 c 6 9 6 a a a a a 
a c 6 a c 3 c 3 9 6 9 6 a a a a 
a 9 1 4 3 c 3 c 6 9 6 9 6 c 6 a 
a a e b c 3 c 3 9 6 9 6 9 5 5 6 
a a b c 3 c 3 c 6 9 6 d 4 5 5 3 
a c 2 d 4 3 c 5 5 6 d 5 1 5 5 6 
8 3 c 5 5 4 5 5 1 5 7 d 4 5 5 3 
e c 5 5 5 5 5 5 4 5 5 5 5 5 5 6 
