9 5 5 5 5 5 5 5 5 5 5 5 5 5 5 3 
a 9 5 5 5 5 5 5 5 5 5 5 5 1 7 a 
a a 9 3 9 1 5 5 5 5 1 5 3 c 3 a 
a a a a a c 1 5 5 1 6 b c 3 c 2 
a a a a 8 7 c 3 9 6 9 0 7 8 7 a 
a a a a 8 5 7 8 2 d 2 c 1 6 b e 
a a a a 8 7 9 6 c 3 c 3 e d 0 7 
a a a 8 6 9 6 9 3 c 3 c 3 9 4 3 
a a a e 9 6 9 4 4 3 c 3 c 6 9 6 
a 8 6 9 6 b c 3 9 6 b c 3 d 0 7 
a e 9 6 9 0 7 8 2 d 0 3 c 3 c 3 
a d 2 9 6 c 1 6 c 1 6 c 3 8 7 a 
a d 0 2 b 9 4 3 9 4 3 b 8 6 9 6 
c 3 a c 0 6 b c 6 b c 0 6 d 0 7 
9 2 c 5 6 9 4 3 9 4 3 e 9 3 c 3 
e c 5 5 5 6 d 4 4 7 c 5 6 c 5 6 
