9 5 5 5 5 5 5 5 5 5 5 5 5 5 5 3 
c 3 9 5 1 5 1 1 1 1 5 1 5 1 5 2 
b a 8 7 a b a a e a 9 6 b 8 5 2 
8 2 a d 2 e a 8 3 8 6 d 0 2 9 2 
a a c 1 4 1 4 6 8 2 d 1 6 8 6 a 
8 6 b e b a d 1 2 c 1 6 d 2 9 2 
c 3 8 5 2 e 9 6 e 9 0 5 3 8 2 a 
9 2 8 5 6 9 6 9 3 a c 3 a a 8 2 
a a a d 5 4 3 8 6 c 5 4 6 c 2 a 
8 2 8 5 1 7 8 2 9 7 9 5 5 3 8 2 
a c 6 9 6 b e c 2 9 6 b b c 2 a 
8 5 1 6 9 4 5 3 e c 5 0 4 3 c 2 
8 1 6 9 4 1 7 e 9 1 1 0 1 4 3 a 
a 8 3 c 1 4 1 5 2 a a a a b c 2 
8 2 e 9 4 1 4 3 8 0 0 0 0 0 1 2 
e c 5 4 5 4 5 4 6 e e e e e e e 
