9 1 1 1 1 1 1 1 1 1 1 1 1 1 1 3 
8 0 0 0 0 0 0 0 0 0 0 0 0 0 0 2 
8 0 0 0 0 0 0 0 0 0 0 0 0 0 0 2 
8 0 0 0 0 0 0 0 0 0 0 0 0 0 0 2 
8 0 0 0 0 0 0 0 0 0 0 0 0 0 0 2 
c 4 4 4 4 4 4 4 4 0 0 0 0 0 0 2 
b 9 3 9 3 9 1 5 7 8 0 0 0 0 0 2 
8 2 8 2 8 2 a 9 3 8 0 0 0 0 0 2 
a 8 2 8 2 8 2 c 2 8 0 0 0 0 0 2 
8 2 8 2 8 2 8 5 2 8 0 0 0 0 0 2 
a 8 6 c 2 c 4 5 6 8 0 0 0 0 0 2 
a c 5 5 6 9 1 1 1 0 0 0 0 0 0 2 
c 5 5 5 3 8 0 0 0 0 0 0 0 0 0 2 
9 3 9 1 2 8 0 0 0 0 0 0 0 0 0 2 
a a a a a 8 0 0 0 0 0 0 0 0 0 2 
e c 4 4 6 c 4 4 4 4 4 4 4 4 4 6 
