9 1 1 5 5 5 1 3 9 1 3 9 1 1 3 b 
a a c 1 7 9 2 a a a a a a a a a 
c 4 3 8 3 e e a e a a c 2 e c 6 
9 5 2 a 8 1 5 4 5 2 8 5 4 1 5 3 
8 3 a e e c 1 5 1 4 2 9 1 4 5 2 
a c 0 3 9 5 4 3 8 7 a a e 9 5 2 
8 5 6 c 4 5 7 e e 9 2 c 5 4 7 a 
a d 3 d 1 1 7 9 3 e a d 1 5 3 a 
8 5 4 5 6 8 3 8 6 9 0 7 c 3 c 2 
a d 1 5 5 6 a a 9 2 a b b a b a 
8 5 6 9 5 1 2 a e e a a 8 2 8 2 
8 3 9 4 1 6 a c 1 5 6 a a a e a 
a a e 9 6 d 2 d 6 b d 2 a a 9 2 
8 6 9 4 5 5 0 1 7 8 3 8 2 8 4 2 
8 1 6 d 5 5 6 8 5 6 a a e e b a 
e c 5 5 5 5 5 4 5 5 4 4 5 5 4 6 
