9 5 1 1 5 7 9 3 b b 9 5 1 5 1 3 
8 1 2 c 5 5 2 c 0 0 0 7 c 3 e a 
a a c 1 5 5 4 3 a e e b 9 6 9 6 
a c 3 c 1 5 1 6 a 9 3 8 6 9 2 b 
a 9 0 5 4 3 c 5 2 a c 6 9 2 8 6 
a e a d 3 c 3 b 8 6 b 9 6 c 4 3 
a 9 6 b 8 1 2 c 6 b 8 6 9 3 9 2 
c 0 5 6 a a a 9 1 4 4 5 6 c 6 a 
d 0 5 5 0 4 2 c 6 9 7 d 3 9 5 6 
b c 3 9 2 9 2 9 5 0 5 5 2 c 1 3 
8 1 6 e e e a a 9 4 3 9 0 7 e a 
a c 5 1 7 b a e c 1 6 e 8 5 5 6 
a b d 0 7 8 6 d 1 4 7 d 2 9 7 b 
8 6 d 0 7 8 1 1 2 b 9 3 c 0 1 6 
a 9 5 0 5 2 e e c 0 2 c 3 e 8 7 
e c 7 c 7 c 5 5 7 e c 7 c 5 4 7 
