d 3 9 3 b 9 5 5 5 5 5 5 3 d 5 3 
b a a 8 4 6 b 9 3 d 3 9 6 9 5 2 
8 2 a a d 1 2 a 8 3 a 8 7 c 3 a 
a c 6 a b a c 6 e c 2 c 5 5 6 a 
a 9 3 a c 0 1 3 9 5 4 1 5 5 3 a 
a a a c 1 6 a a a 9 5 4 5 3 8 2 
a a 8 3 c 3 e c 6 c 5 3 9 6 a a 
8 2 a c 3 c 3 9 3 9 3 e a d 6 e 
a a 8 3 c 3 a c 4 6 c 5 4 5 5 3 
8 2 a 8 3 a c 3 9 5 5 5 5 5 5 6 
a a a a a 8 5 6 c 5 5 1 5 5 5 7 
8 2 a a a 8 5 5 5 5 5 2 9 1 1 3 
e e a a a c 3 d 5 5 5 4 6 e a a 
9 5 0 2 a b c 1 7 b b b b 9 6 a 
a b a a e 8 3 c 5 0 0 0 0 0 1 2 
e c 6 c 7 e c 5 5 6 e e e e e e 
