9 3 9 3 9 5 3 9 3 9 1 5 3 9 1 3 
a a a a c 3 c 6 a a a 9 6 a e a 
a a a c 3 c 5 3 c 6 a a f a 9 6 
a a a f c 5 3 c 5 3 a a f a c 3 
a c 2 d 3 f c 5 5 6 a c 5 6 d 2 
a b 8 7 8 5 5 5 5 1 2 9 5 3 9 6 
8 2 e d 4 5 1 5 7 a a a 9 6 c 3 
a a 9 3 9 1 6 9 1 6 8 6 c 3 9 6 
e a a a e c 3 c 6 f e b 9 6 c 3 
f a a a 9 3 a 9 3 9 5 2 c 3 9 6 
9 2 a a a a a a a a b c 1 6 8 3 
a a a a a a c 6 c 0 6 9 6 9 6 a 
a a a a a c 5 5 5 6 9 6 9 6 9 2 
a a a c 4 5 5 5 5 1 6 9 6 9 2 a 
a a c 5 5 1 5 5 7 c 5 6 9 6 a a 
e c 5 5 5 4 5 5 5 5 5 5 4 5 4 6 
