d 3 9 1 5 1 5 1 3 9 3 9 5 5 5 3 
9 6 a a b a b a a e a a 9 5 3 a 
c 5 6 a a a a e c 5 4 2 a 9 6 a 
d 5 5 2 a e a 9 1 3 b a a c 5 6 
9 5 5 4 4 5 6 a e a 8 2 c 1 3 b 
c 3 9 3 9 1 7 c 3 c 6 a 9 2 a a 
b c 6 8 6 a 9 5 4 3 9 2 a a a a 
8 5 1 2 b e a 9 3 a a c 0 6 c 2 
a 9 6 a e b a 8 6 a c 5 6 d 5 2 
8 6 9 4 7 a c 4 5 6 d 1 5 5 7 a 
a 9 6 9 5 0 5 7 d 5 3 a d 5 5 2 
c 4 5 2 f c 3 d 7 9 6 8 5 5 7 a 
9 5 5 4 1 1 4 1 1 4 3 8 1 5 5 2 
a 9 5 3 a a d 6 a 9 6 a a 9 5 6 
a a f a a a d 3 a c 3 a a a 9 3 
e c 5 4 6 c 5 4 4 7 c 6 e c 6 e 
