9 5 5 5 5 5 5 5 5 5 5 5 5 5 5 3 
a 9 5 5 5 5 5 5 5 5 5 5 5 5 3 a 
a a 9 5 5 5 5 1 5 1 5 5 5 3 a a 
a a a b 9 5 3 8 7 8 7 9 3 a a a 
a a c 2 a 9 6 a 9 6 9 6 a a a a 
a a b a a c 5 2 a 9 6 9 6 a a a 
a a 8 6 a 9 3 e c 6 9 6 b a a a 
a a a b a a a 9 3 9 6 9 2 a a a 
a a 8 6 a a a c 2 8 5 2 a a a a 
8 4 0 5 2 a c 5 2 e 9 4 6 a a a 
a 9 4 1 6 c 5 3 a 9 6 9 3 a a a 
8 4 1 4 1 5 3 a a c 5 6 a a a a 
8 5 0 5 0 5 2 a c 5 5 5 6 a a a 
8 1 4 1 4 1 2 a d 5 5 5 5 6 a a 
a c 1 4 1 6 a c 5 5 5 5 5 5 6 a 
e d 4 5 4 5 4 5 5 5 5 5 5 5 5 6 
