9 5 5 1 5 5 1 5 5 1 1 5 1 5 5 3 
c 5 5 4 5 5 4 5 5 6 a d 4 5 5 6 
9 1 5 5 5 5 1 1 1 1 4 5 5 1 5 3 
a 8 5 5 5 3 a a a a 9 5 5 4 1 2 
a 8 5 5 7 a a c 6 a 8 1 5 3 a a 
a 8 5 5 5 6 c 5 5 6 a 8 7 a 8 2 
e c 5 5 5 5 3 d 5 1 6 e 9 2 a a 
9 5 5 1 5 5 2 9 3 a 9 5 6 c 0 2 
a 9 3 e 9 3 a 8 6 e a 9 3 9 2 a 
a a c 5 6 a a c 5 5 6 a c 6 a a 
a c 3 b 9 6 a 9 5 3 9 4 5 5 4 6 
8 7 a a a 9 6 a b a a 9 5 5 5 3 
a 9 6 a a a b a a a a a 9 5 5 6 
a a 9 6 a a a a a a a a a 9 5 3 
a a c 5 6 c 2 a a a a a a a 9 6 
e c 5 5 5 5 4 4 4 4 4 6 c 6 c 7 
