9 5 5 5 5 5 5 5 5 5 5 5 5 5 5 3 
a 9 5 5 5 5 5 5 5 5 5 5 5 5 5 2 
a a 9 1 5 5 1 5 5 5 5 5 5 5 5 2 
a a a c 5 3 c 5 5 3 b 9 3 9 1 2 
a a 8 5 1 6 9 5 5 6 a a a a e a 
a a a 9 0 7 c 5 5 5 2 a a c 3 a 
a a a a e b 9 5 5 3 a a a 9 6 a 
a a a c 3 a a 9 3 a a a a c 3 a 
a a a 9 4 2 8 4 6 a 8 2 c 3 a a 
a a a e 9 2 c 5 1 6 e 8 3 c 2 a 
a a a 9 2 e b 9 6 9 3 e c 3 e a 
a a a a e b 8 6 9 6 a d 5 4 3 a 
a a a c 1 6 c 5 4 7 a 9 3 9 2 a 
8 2 a d 4 5 5 5 5 5 4 6 c 6 a a 
a a c 5 5 5 5 5 5 5 5 5 5 5 6 a 
e c 5 5 5 5 5 5 5 5 5 5 5 5 5 6 
