9 3 b 9 1 5 5 1 5 5 5 3 b 9 5 3 
a c 0 6 8 5 3 e 9 3 d 2 8 2 b a 
c 3 c 3 c 5 0 5 6 a b c 6 c 6 a 
d 4 3 c 1 7 8 5 1 4 6 9 5 5 5 6 
9 1 4 3 c 3 8 3 c 3 b c 5 3 d 3 
a a 9 4 1 6 e c 1 4 2 b d 4 5 2 
8 2 a d 0 5 1 7 e 9 6 8 5 3 d 2 
a e 8 7 a b a 9 3 e b 8 5 4 5 2 
8 5 2 b 8 4 2 8 6 d 4 2 9 1 5 2 
a b e a c 3 c 6 d 1 3 e a c 1 2 
c 4 5 4 3 c 5 3 9 6 a 9 4 5 6 a 
9 5 5 3 c 5 3 c 4 5 6 a 9 5 3 a 
8 5 3 c 5 3 a d 5 5 1 2 c 3 a a 
a b c 5 3 a a f 9 3 a c 5 6 a a 
8 0 7 9 6 a 8 5 6 e c 1 5 5 4 2 
e c 5 4 5 4 4 5 5 5 5 4 5 5 5 6 
