9 5 5 5 5 5 5 1 5 5 5 5 5 5 5 3 
a 9 5 1 5 5 5 2 d 5 1 1 1 1 1 2 
a a 9 2 9 1 5 4 5 7 a a e e e a 
a a a a e c 7 9 1 5 4 4 5 5 3 a 
a a c 4 1 5 7 a c 5 5 5 5 5 2 a 
a 8 5 3 a d 1 4 5 5 5 5 5 7 a a 
a a f a 8 7 c 5 5 7 d 5 1 5 2 a 
a 8 5 6 8 5 3 9 3 f d 3 a f a a 
a 8 5 5 4 3 a c 4 5 3 a 8 5 2 a 
a 8 7 d 3 c 6 b d 7 a 8 6 b a a 
a c 5 3 8 1 5 4 3 d 4 6 d 2 e a 
c 1 3 a a 8 5 3 8 1 5 5 1 4 1 2 
d 6 a 8 4 6 b a e a 9 3 a b a a 
9 5 2 8 1 5 6 8 5 2 a 8 6 a a a 
a b a e c 5 5 4 7 c 4 4 5 4 6 a 
e e c 5 5 5 5 5 5 5 5 5 5 5 5 6 
