9 5 5 5 5 5 1 5 5 5 1 5 5 5 5 3 
c 3 9 1 5 5 4 5 5 1 6 9 5 1 1 2 
9 2 a c 1 5 5 1 5 4 5 2 9 2 a a 
a a a 9 2 9 5 4 5 5 5 2 a a 8 2 
8 6 c 2 c 2 9 5 5 5 3 c 2 8 2 a 
a 9 3 c 3 a 8 5 1 1 0 3 a a a a 
a a c 3 a a 8 5 6 a a a 8 6 a a 
a c 3 c 4 6 a 9 3 a a a a 9 6 a 
8 3 a 9 5 5 2 c 4 6 8 2 a a 9 6 
a a a c 5 5 6 9 5 5 6 a 8 2 8 3 
a a 8 1 5 5 3 c 5 5 1 2 a a a a 
8 6 a 8 3 9 4 5 1 5 6 a a a a a 
a 9 6 a 8 4 1 5 4 5 5 6 8 2 a a 
a c 3 8 4 5 4 5 5 3 9 5 6 e 8 6 
8 3 c 6 9 5 5 5 3 c 6 9 5 5 4 3 
e c 5 5 4 5 5 5 4 5 5 4 5 5 5 6 
