9 5 5 5 5 5 5 5 5 5 5 5 1 5 5 3 
a 9 1 3 9 5 1 7 d 5 1 3 a 9 7 a 
a a a a a d 0 7 b b a a 8 6 9 6 
c 0 4 2 a d 0 7 8 4 6 c 2 d 0 7 
9 4 1 4 6 9 4 3 a 9 5 5 2 9 6 b 
c 5 6 b b 8 5 6 a c 5 5 6 8 5 2 
9 5 3 8 6 a 9 3 c 5 3 d 5 6 b a 
8 1 0 4 7 c 2 8 3 9 4 5 5 5 6 e 
a a a 9 1 7 e c 6 8 3 9 3 9 1 3 
a a 8 2 a b 9 5 5 2 a a 8 6 a e 
a a a 8 0 0 0 1 3 8 2 8 2 b 8 3 
8 0 0 2 a a a a 8 6 8 6 8 2 a e 
a e a 8 4 0 4 0 6 9 6 9 6 8 0 7 
8 3 c 4 1 4 1 2 9 6 9 6 9 4 0 7 
a a b 9 4 1 2 8 2 9 6 9 6 9 0 3 
e c 6 c 5 6 c 6 c 6 d 4 5 6 e e 
