9 1 5 3 9 1 5 1 1 5 5 5 1 5 5 3 
a c 3 c 6 a f a e 9 5 7 c 5 1 6 
c 1 4 3 9 4 5 4 1 0 5 5 5 7 8 3 
9 2 f a 8 7 d 3 e 8 5 1 3 9 6 a 
a c 5 0 6 9 3 c 3 a f a c 6 9 2 
8 3 b a d 2 c 3 e 8 5 2 9 5 2 a 
e 8 2 8 7 c 3 c 3 e b e a f a a 
9 6 8 2 d 5 4 1 0 1 4 5 4 5 4 2 
8 3 a c 1 5 3 c 6 c 3 9 5 3 9 6 
a c 6 b a f a 9 5 3 c 2 f 8 4 3 
c 3 9 2 c 5 2 a f 8 3 c 1 4 3 a 
b 8 6 8 5 3 a c 1 6 8 3 c 3 c 2 
a a d 2 f a 8 3 8 3 a c 3 c 3 a 
8 6 f c 1 6 a 8 2 c 2 f 8 1 0 2 
a 9 5 5 6 f 8 6 c 3 8 5 2 e e a 
e c 5 5 5 5 6 d 7 c 4 5 4 5 5 6 
