9 5 1 5 5 5 5 5 5 5 5 5 5 5 5 3 
8 7 a 9 5 5 5 7 9 3 9 5 5 5 7 a 
8 7 a e 9 5 5 1 6 c 2 9 5 1 5 2 
8 1 6 9 6 9 3 c 5 3 a a 9 6 9 2 
a e 9 6 9 6 c 5 3 a a 8 6 9 2 a 
8 7 a 9 0 1 7 b a a a a 9 6 a a 
a 9 6 a a a d 4 2 a e a e 9 6 a 
a a d 4 2 8 1 1 2 8 5 6 d 2 d 2 
a 8 5 3 a a e c 2 a 9 5 3 c 3 a 
a a d 2 a a 9 3 a a 8 1 2 f e a 
a c 3 e a 8 2 e a a a a 8 1 3 a 
a b c 3 a a e 9 6 a a a a a a a 
8 6 9 6 a a 9 6 9 6 a a a a a a 
a 9 6 9 2 a a 9 6 d 2 a e a a a 
8 6 9 6 a c 4 6 9 7 a 8 5 2 a a 
e d 6 d 4 5 5 5 4 5 6 e d 6 c 6 
