9 5 5 1 5 1 1 5 5 5 5 1 5 5 3 f 
a f 9 6 9 6 a d 1 5 3 c 1 5 4 3 
e 9 6 9 6 d 4 3 8 7 8 3 c 3 d 2 
9 6 9 6 9 5 3 e a b e c 7 8 3 e 
a 9 6 9 6 b 8 7 a c 1 7 9 6 c 3 
8 6 9 6 f a a d 0 7 e 9 2 d 5 2 
a 9 6 9 5 6 8 7 c 5 1 6 a 9 3 a 
c 6 f a 9 3 a 9 3 b e 9 6 a a a 
d 5 1 6 a a c 4 6 e 9 6 b a a a 
f 9 6 9 6 8 7 9 7 9 6 9 2 e a e 
9 6 9 6 9 6 9 6 9 6 9 6 c 3 c 3 
a 9 6 9 6 d 6 9 6 9 2 9 3 c 3 a 
8 6 9 6 9 5 5 0 7 a e a e 9 6 a 
a 9 6 9 6 9 5 6 9 6 d 4 1 6 9 2 
8 2 d 2 d 0 7 9 6 d 7 9 6 9 6 a 
e c 5 4 7 c 5 6 d 5 5 4 5 6 d 6 
