9 5 5 5 5 5 5 5 5 5 5 5 5 5 5 3 
a 9 5 5 5 5 5 5 5 5 1 5 5 5 5 2 
a a 9 5 5 5 1 5 7 d 4 1 5 5 3 a 
a a a b 9 3 c 5 3 b 9 6 9 5 6 a 
a a a 8 6 a 9 3 c 2 a d 4 5 3 a 
a a a c 3 a a c 3 c 6 9 5 5 6 a 
a a c 5 2 a a d 4 5 3 c 5 3 b a 
a a 9 3 e a a 9 1 3 c 5 5 6 a a 
a a a c 3 a a c 6 c 1 7 9 1 2 a 
a a a 9 6 8 6 d 1 3 c 3 a e a a 
a a a c 5 6 9 3 a c 3 c 0 5 2 a 
a a c 5 5 3 a a c 3 c 3 c 3 a a 
a a 9 5 5 6 a a d 4 3 c 3 c 2 a 
8 2 a d 5 5 2 a d 5 4 3 c 3 a a 
a a c 5 5 5 6 c 5 5 5 6 d 4 6 a 
e c 5 5 5 5 5 5 5 5 5 5 5 5 5 6 
