9 5 5 5 5 5 5 5 5 5 5 1 5 5 5 3 
a 9 5 3 d 5 5 5 5 5 5 2 d 1 3 a 
8 2 9 4 5 3 d 5 5 5 3 c 5 2 a a 
a 8 2 9 5 0 5 5 1 5 4 5 3 8 2 a 
8 2 a a 9 6 d 5 4 5 5 3 8 2 a a 
a 8 2 a a 9 5 5 5 5 1 2 a a a a 
a a 8 2 8 2 9 5 5 3 a a a 8 2 a 
8 2 a a a a a 9 3 a a c 0 2 a a 
a a 8 2 a a a c 4 0 4 1 2 a a a 
a a a a a 8 4 1 5 6 9 2 a 8 2 a 
a a a 8 2 a d 4 5 5 6 a a a a a 
8 2 a a a c 5 1 5 5 5 4 2 8 0 2 
a a 8 2 c 5 5 4 5 5 5 5 6 a a a 
a 8 2 c 1 1 5 5 5 5 3 9 5 6 a a 
a a c 5 2 a d 5 5 7 c 2 d 5 6 a 
e c 5 5 4 4 5 5 5 5 5 4 5 5 5 6 
