9 5 5 5 5 5 5 5 5 5 5 5 5 5 1 7 
c 5 5 5 5 5 5 3 9 3 9 3 b 9 0 3 
9 5 5 3 9 3 9 2 a c 2 c 0 6 e a 
a 9 3 c 6 c 6 a c 3 c 5 4 7 9 6 
a a a b b b 9 6 9 6 9 1 1 3 c 3 
a a c 0 0 0 6 9 6 9 6 c 6 c 3 a 
a c 3 e e e 9 6 d 0 7 9 3 9 4 6 
c 1 4 1 7 d 0 1 1 6 9 2 a c 5 3 
9 4 1 4 1 3 a c 6 9 6 e c 5 5 6 
c 1 4 1 2 a e b b c 5 5 5 5 5 3 
b c 1 2 8 4 3 8 4 1 1 3 9 3 9 6 
a 9 2 8 6 9 6 a 9 6 a c 6 c 4 7 
8 2 8 6 9 6 9 6 a d 0 3 9 3 9 3 
a 8 6 9 6 9 6 9 2 9 2 8 2 8 2 a 
8 0 3 c 5 4 5 6 c 6 c 6 c 6 c 2 
e e c 5 5 5 5 5 5 5 5 5 5 5 5 6 
