b 9 5 5 5 5 7 9 5 5 3 9 5 5 5 3 
a 8 5 5 1 5 5 0 5 7 8 0 5 5 1 2 
a 8 5 5 4 5 1 6 9 5 6 c 5 5 2 a 
a a b 9 5 1 4 5 4 5 1 7 9 5 2 a 
8 2 8 2 f 8 5 5 5 5 2 d 4 3 8 2 
a e a c 5 2 b 9 5 5 4 5 3 a a a 
a 9 4 5 7 a a c 5 5 5 5 6 e a a 
8 4 5 5 5 4 6 9 1 5 5 1 5 5 4 6 
8 1 5 5 5 1 3 c 6 d 5 4 5 5 1 3 
a c 1 5 7 a a 9 5 5 5 5 3 b a a 
a b a 9 5 2 e c 5 5 1 5 6 a a a 
8 2 8 2 f 8 5 5 5 5 2 d 1 6 8 2 
a a e c 5 4 1 5 1 5 4 7 c 5 2 a 
a 8 5 5 1 5 4 3 c 5 3 9 5 5 2 a 
a 8 5 5 4 5 5 0 5 7 8 0 5 5 4 2 
e c 5 5 5 5 7 c 5 5 6 c 5 5 5 6 
