9 5 5 5 5 5 5 5 5 5 1 5 5 1 5 3 
8 5 1 5 1 5 1 5 3 b a 9 5 2 f a 
a b a b a b a b a a e 8 3 c 1 2 
a a a a a a a a a a 9 2 c 3 a a 
e a e a e a e a a 8 2 c 1 4 6 a 
9 4 5 4 5 4 5 4 6 a c 1 6 d 5 2 
8 5 5 5 1 5 7 d 5 0 5 4 5 5 7 a 
8 5 5 1 4 5 3 9 3 a 9 5 5 5 3 a 
c 5 5 4 1 5 2 c 4 6 8 5 5 7 a a 
9 5 5 5 0 7 c 1 3 b a d 5 5 2 a 
8 5 1 7 c 3 b a a a 8 5 5 7 a a 
c 1 4 5 3 c 0 2 8 2 a d 5 5 2 a 
9 6 9 3 a b a 8 2 a 8 5 5 7 a a 
c 1 2 e 8 2 a a a a a d 5 5 2 a 
9 2 a 9 2 a a a a a 8 5 5 7 a a 
e c 4 6 c 4 6 c 4 4 6 d 5 5 4 6 
