9 5 1 5 1 5 1 5 1 5 5 5 5 1 5 3 
a b a b a b a b a d 5 1 1 2 f a 
a a a a a a a a a d 5 2 e c 1 2 
a a e a e a e a e d 1 4 3 d 2 a 
c 4 5 4 5 4 5 4 3 9 2 f 8 1 2 a 
9 5 5 5 5 5 5 5 6 a c 1 2 a a a 
a 9 5 5 5 5 3 d 5 0 5 6 e e e a 
8 4 5 5 5 5 2 9 3 a 9 3 d 5 5 2 
c 5 5 5 1 5 2 c 4 6 a 8 5 5 7 a 
9 5 5 5 4 3 c 1 1 3 a a d 5 5 2 
8 5 5 5 3 c 3 a a a a 8 5 5 7 a 
c 1 1 5 0 3 8 2 a a a a d 5 5 2 
9 6 a b a a a a a a a 8 5 5 7 a 
c 3 e a a a a a a a a a d 5 5 2 
9 2 9 0 2 a a a 8 6 a 8 5 5 7 a 
e c 6 e c 4 6 c 4 5 6 c 5 5 5 6 
