9 5 5 5 5 5 1 1 5 5 5 7 9 5 1 7 
a 9 5 5 5 5 2 c 1 5 5 1 4 7 8 3 
a c 1 3 9 3 8 5 4 1 5 0 7 9 6 a 
a b a a e c 0 5 5 0 5 6 9 6 9 2 
c 2 c 4 5 1 4 5 1 4 7 9 6 b a a 
9 6 9 5 3 c 1 5 4 3 9 6 d 2 a a 
8 1 6 b c 3 c 5 5 6 a b 9 0 0 2 
a a 9 0 5 4 3 9 1 5 6 c 2 a e e 
a 8 2 c 1 7 a c 6 9 1 7 8 4 3 b 
a a 8 1 0 5 2 9 5 2 a 9 0 3 8 2 
c 4 2 e a b 8 4 5 4 2 e e 8 6 e 
9 3 a 9 0 0 4 3 d 1 4 1 3 c 1 3 
a a 8 6 e e d 6 d 4 7 e a b e a 
8 0 0 7 b b f 9 7 9 7 b a 8 1 2 
a a c 1 4 4 5 4 7 c 1 0 6 a e a 
e c 5 4 5 5 5 5 5 5 6 c 5 4 5 6 
