9 1 1 1 1 1 1 1 1 1 1 1 1 1 1 3 
8 0 0 0 0 0 0 0 0 0 0 0 0 0 0 2 
8 0 0 0 0 0 0 0 0 0 0 0 0 0 0 2 
8 0 0 0 0 0 0 0 0 0 0 0 0 0 0 2 
8 0 0 0 0 0 0 0 0 0 0 0 0 0 0 2 
8 0 0 0 0 0 0 0 0 0 0 0 0 0 0 2 
8 0 0 0 0 0 0 0 0 0 0 0 0 0 0 2 
8 0 0 0 0 0 0 0 0 0 0 0 0 0 0 2 
8 0 0 0 0 0 0 0 0 0 0 0 0 0 0 2 
8 0 0 0 0 0 0 0 0 0 0 0 0 0 0 2 
c 4 4 4 4 4 4 4 4 4 0 0 0 0 0 2 
9 5 5 5 5 5 5 5 5 3 8 0 0 0 0 2 
a 9 5 5 3 9 5 5 1 2 8 0 0 0 0 2 
a 8 3 9 6 8 1 5 2 a 8 0 0 0 0 2 
a a c 4 1 2 c 5 4 2 8 0 0 0 0 2 
e c 5 5 6 c 5 5 5 6 c 4 4 4 4 6 
