9 5 5 5 5 5 5 5 5 5 5 5 5 5 5 3 
a 9 5 5 5 5 5 5 5 5 5 5 5 5 1 2 
a 8 5 5 3 9 3 9 5 5 3 9 5 3 a a 
a a 9 1 6 a c 6 9 3 a c 3 a a a 
a a a e 9 6 b 9 6 a a 9 6 a a a 
a a a 9 6 b 8 4 3 a a c 3 a a a 
a a a a b 8 4 5 6 c 6 d 2 a a a 
a a c 6 8 4 3 9 3 9 5 1 2 a a a 
a a 9 5 4 5 6 c 2 c 1 2 e a a a 
a a c 3 9 5 1 5 6 9 2 e 9 6 a a 
a a 9 6 8 3 e d 1 2 e 9 6 b a a 
a a c 3 a e b 9 6 e 9 6 9 2 a a 
a c 3 8 6 9 2 c 3 9 6 9 6 a a a 
8 3 a c 5 6 c 5 6 c 5 6 d 2 a a 
a a c 5 5 5 5 5 5 5 5 5 5 4 6 a 
e c 5 5 5 5 5 5 5 5 5 5 5 5 5 6 
