9 5 5 5 5 5 5 5 5 5 5 5 5 5 5 7 
a 9 5 5 5 5 5 5 5 5 5 5 5 5 5 3 
a a 9 1 5 5 5 5 1 1 1 1 1 1 3 a 
a a c 6 9 3 9 3 c 0 0 0 0 0 2 a 
a c 5 5 2 8 2 8 3 8 0 0 0 0 2 a 
8 1 1 3 c 6 c 6 a 8 0 0 0 0 2 a 
8 0 0 0 1 1 1 7 a 8 0 0 0 0 2 a 
8 0 0 0 0 0 2 9 2 8 0 0 0 0 2 a 
8 0 0 0 0 0 2 c 6 8 0 0 0 0 2 a 
8 0 0 0 0 0 0 1 1 0 0 0 0 0 2 a 
8 0 0 4 4 4 4 0 4 4 0 0 0 0 2 a 
8 0 6 9 3 9 3 e 9 3 c 4 4 4 2 a 
8 2 9 2 8 2 8 5 6 a 9 3 9 3 e a 
c 6 a c 6 c 6 9 3 c 2 8 2 8 5 6 
9 5 6 9 1 1 1 0 0 3 c 6 c 6 9 3 
e d 5 4 4 4 4 4 4 4 5 5 5 5 4 6 
