9 5 5 5 5 3 9 5 1 5 1 5 5 5 5 3 
a 9 5 5 3 a c 1 4 1 6 9 5 1 7 a 
a c 3 d 6 a 9 4 1 4 3 c 1 4 3 a 
8 3 c 5 5 6 c 1 4 1 6 9 4 1 6 a 
a 8 1 5 3 b 9 4 1 4 3 c 1 4 3 a 
a a 8 1 6 a c 1 4 1 6 9 4 1 6 a 
a c 6 c 1 6 d 4 1 4 7 c 1 4 3 a 
c 5 5 3 c 1 7 9 2 9 5 1 4 1 6 a 
9 5 5 4 3 8 3 c 6 c 1 4 1 4 3 a 
c 5 5 3 a e c 1 5 1 4 1 4 1 6 a 
9 5 5 6 c 5 3 c 1 4 1 4 1 4 3 a 
c 5 5 3 9 5 4 3 c 1 4 1 4 1 6 a 
9 1 5 2 8 1 5 4 3 c 1 4 1 4 3 a 
a a b c 6 a 9 3 8 3 c 1 4 1 6 a 
a a c 5 3 a c 6 a a b c 3 c 7 a 
e c 5 5 6 c 5 5 4 4 6 d 4 5 5 6 
