9 1 5 5 1 5 3 9 5 5 1 1 5 5 5 3 
a c 1 7 a d 6 a b b a a d 1 7 a 
a b c 3 c 5 5 2 8 6 a c 1 6 9 2 
8 2 b c 1 5 3 c 4 7 c 1 6 9 2 a 
a c 4 7 c 3 a 9 3 d 1 6 9 6 a e 
8 5 3 d 3 e a a a 9 6 9 6 d 0 3 
8 7 8 5 4 3 c 6 a e 9 6 d 5 6 a 
8 7 c 5 5 0 7 9 2 d 6 9 5 3 d 2 
8 3 9 1 3 e 9 4 6 b d 6 d 2 d 2 
a c 6 a e 9 6 9 7 c 3 d 5 4 1 2 
a 9 1 6 9 6 9 6 9 3 c 3 9 5 2 a 
a a e 9 6 9 6 9 2 c 3 c 4 7 c 2 
8 6 9 6 9 6 d 6 a b a d 5 1 5 6 
a 9 6 9 6 b b 9 6 c 4 5 3 c 5 3 
8 6 9 6 9 2 c 2 9 5 1 7 c 3 d 2 
e d 4 5 6 c 5 6 e d 4 5 5 4 5 6 
