b 9 5 5 1 1 5 7 d 5 1 1 5 5 3 b 
a a d 7 a c 1 1 1 1 6 a d 7 a a 
a a 9 5 2 b a a a a 9 2 d 3 a a 
a a a f a a a a a a a e f a a a 
8 4 4 5 2 e a a a c 6 9 5 4 4 2 
a b d 7 a 9 6 c 6 f f a d 7 b a 
a 8 5 5 4 6 9 5 5 3 d 4 5 5 2 a 
a c 5 5 5 3 a 9 3 8 5 1 5 5 2 a 
8 5 5 5 5 6 a 8 6 a d 4 5 5 2 a 
a 9 5 5 1 3 c 4 5 6 9 3 d 5 2 a 
a e d 7 a c 3 9 3 9 6 a d 7 e a 
a 9 1 5 2 b a a a a b 8 5 1 1 2 
8 2 a f a a a a a a a a f a a a 
a a c 5 2 e a a c 2 e 8 5 6 a a 
a a d 7 a 9 4 4 5 4 3 a d 7 a a 
e c 5 5 4 4 5 7 d 5 4 4 5 5 6 e 
