9 1 5 5 5 5 1 1 5 5 1 5 5 3 9 3 
a a 9 5 5 7 a a d 1 4 5 3 a a a 
a e a d 5 5 2 c 5 4 5 5 4 0 6 a 
c 3 8 5 1 5 0 1 5 5 1 5 5 0 3 a 
9 6 8 3 a d 6 c 5 3 a b b e a a 
a b e 8 4 1 5 5 3 c 2 8 0 5 6 a 
a c 5 2 9 6 9 3 c 3 a a 8 5 1 6 
8 3 9 6 e 9 6 8 3 a a 8 2 9 4 3 
a a a 9 7 c 3 c 6 a a a 8 0 3 a 
a a a c 5 3 c 1 5 6 a c 6 a a a 
a a 8 3 d 0 5 6 9 5 4 5 7 a a a 
8 2 a c 3 a d 5 6 9 3 9 5 0 0 6 
a a c 5 4 4 7 9 5 6 a 8 5 6 8 3 
a 8 5 5 5 5 3 a 9 5 4 0 5 7 a a 
a c 5 1 1 5 4 6 a d 3 c 5 1 2 a 
e d 5 6 c 5 5 5 4 5 4 5 5 6 e e 
