9 5 5 3 9 5 5 3 9 5 5 3 9 1 1 3 
8 5 7 c 2 d 5 0 0 5 7 8 2 a a a 
a 9 5 7 8 5 7 a a d 5 2 a e e a 
c 0 5 7 c 5 5 0 0 5 5 6 c 5 1 6 
9 4 1 3 d 5 5 6 c 5 3 b 9 1 4 3 
a b a a d 5 1 5 5 5 0 2 a a b a 
a a e a d 5 6 d 5 3 a a a e a a 
c 0 5 0 5 1 3 9 3 c 2 c 0 5 0 6 
9 0 5 0 3 a a c 4 3 a 9 0 5 0 3 
a a b a a a c 5 3 a a a a b a a 
a e a a a c 5 5 2 a a a a a e a 
c 1 4 6 c 5 5 3 a c 6 e c 4 1 6 
9 4 5 3 9 5 5 0 0 5 5 3 b b c 3 
8 5 3 a 8 5 7 a a d 5 2 a a b a 
8 3 a 8 2 d 5 0 0 5 7 8 0 6 a a 
e c 4 6 c 5 5 6 c 5 5 6 c 5 4 6 
