9 5 5 5 5 5 5 1 5 5 5 5 5 5 5 3 
a 9 5 5 5 5 5 4 5 5 5 5 5 1 3 a 
a a 9 5 5 5 5 5 5 5 1 5 5 2 a a 
a a a 9 5 5 5 5 5 5 4 5 3 a a a 
a a a a 9 5 5 5 5 5 5 3 a a a a 
a a a a a 9 5 5 1 5 3 a a a a a 
a a a a a a 9 5 4 3 a a a a a a 
8 2 a a a a a 9 3 a a a a 8 0 2 
a a a 8 2 a a 8 6 a a a a a a a 
a a a a a a a c 5 6 8 2 a a a a 
a a a a a a c 5 5 5 6 a a a a a 
a a a a a c 5 5 1 5 5 6 a a a a 
a a a a c 5 5 5 4 5 5 5 6 a a a 
a a a c 5 5 5 5 5 5 5 5 5 6 a a 
8 2 c 5 5 5 5 5 1 5 5 5 5 5 6 a 
e c 5 5 5 5 5 5 4 5 5 5 5 5 5 6 
