9 5 3 d 1 5 5 3 b b 9 3 d 5 5 3 
a 9 4 3 c 5 7 a c 2 a c 5 1 5 6 
a a f c 5 1 3 c 5 2 c 5 7 a 9 3 
a c 1 5 3 a c 1 3 c 5 1 5 2 a a 
8 3 a d 6 8 3 a c 5 3 a 9 4 6 a 
a a 8 5 7 a c 4 5 5 2 a 8 5 5 2 
a a 8 5 3 a 9 5 5 3 c 4 4 3 9 2 
e a 8 7 a e 8 1 3 a d 5 5 2 a a 
9 6 a d 4 3 a c 6 a 9 5 7 a a a 
a d 0 5 7 a c 5 5 4 4 1 1 6 c 2 
8 3 a d 5 4 5 3 9 5 3 a a 9 5 6 
a a 8 5 5 5 7 a a b 8 0 4 4 5 3 
e a 8 5 5 1 5 0 2 a a c 5 1 5 6 
9 6 c 5 1 4 5 6 a a a 9 1 0 5 3 
a 9 5 3 a 9 5 5 2 e a a a a 9 6 
e c 5 4 6 c 5 5 4 5 4 6 c 4 6 f 
