9 1 1 1 1 1 1 1 1 1 1 1 1 1 1 3 
8 0 0 0 0 0 0 0 0 0 0 0 0 0 0 2 
8 0 0 0 0 0 0 0 0 0 0 0 0 0 0 2 
8 0 0 0 0 0 0 0 0 0 0 0 0 0 0 2 
c 4 4 4 4 4 4 4 4 4 4 0 0 0 0 2 
9 5 5 5 5 5 5 5 5 5 3 8 0 0 0 2 
a 9 5 5 5 5 5 5 5 3 a 8 0 0 0 2 
a 8 7 9 5 5 3 9 3 a a 8 0 0 0 2 
a 8 3 a b b c 4 6 8 2 8 0 0 0 2 
a a a a e a b d 7 a a 8 0 0 0 2 
a c 4 4 5 4 4 5 5 6 a 8 0 0 0 2 
c 3 f b 9 5 5 1 5 3 a 8 0 0 0 2 
d 4 3 a a 9 5 2 f a a 8 0 0 0 2 
9 3 a a c 0 3 c 5 6 a 8 0 0 0 2 
a a 8 2 9 2 8 7 9 3 a 8 0 0 0 2 
e c 6 c 6 e c 5 6 e e c 4 4 4 6 
