9 5 5 5 5 5 5 5 5 5 5 5 5 5 5 3 
c 1 5 5 5 5 3 9 5 5 5 5 5 5 5 6 
d 0 7 9 5 5 6 c 5 5 3 9 1 5 5 3 
d 0 7 a 9 5 1 7 9 5 6 a c 1 7 a 
d 0 7 a c 3 c 3 c 3 9 6 9 2 9 6 
d 0 7 c 3 c 3 a 9 4 6 9 2 a c 3 
d 0 7 d 4 3 a c 6 b 9 2 8 6 9 6 
9 2 9 5 3 a a 9 3 8 6 a a 9 4 3 
a a c 3 a c 6 c 4 4 5 4 6 c 1 6 
8 0 5 6 a 9 5 3 9 5 3 9 3 d 4 3 
a 8 3 9 2 a 9 6 a b a a c 5 3 a 
8 2 8 6 a a c 3 c 6 a c 3 9 6 a 
a 8 4 5 0 6 9 4 3 d 0 5 6 c 5 2 
8 6 9 5 6 9 6 9 4 1 6 9 3 9 5 6 
8 3 8 3 9 2 d 4 3 8 5 6 c 4 5 3 
e c 6 c 6 c 5 5 6 c 5 5 5 5 5 6 
