9 5 1 7 9 3 b 9 1 7 9 5 5 5 1 7 
a 9 6 9 6 a c 2 c 3 c 1 3 9 2 b 
a a 9 6 9 6 9 6 9 6 9 6 a a 8 2 
a c 6 9 6 9 6 9 4 7 e 9 6 8 2 e 
a d 1 6 9 6 9 6 9 1 1 4 3 a 8 3 
a 9 6 9 6 9 6 b a e c 3 a 8 2 a 
a a 9 6 9 6 9 6 e d 5 2 a a 8 2 
a c 6 9 6 9 2 9 3 d 5 2 a 8 2 a 
a d 1 6 9 6 e 8 6 d 5 2 a e 8 2 
a 9 6 9 4 1 1 4 3 b d 0 6 9 6 a 
a c 5 4 5 6 a 9 6 a 9 6 d 6 9 6 
c 3 9 5 3 d 4 4 5 4 6 9 5 3 c 3 
d 4 2 d 4 1 5 5 5 5 3 a 9 2 9 6 
9 1 6 9 7 8 5 1 5 1 6 a e a c 3 
a a b 8 1 4 1 4 1 4 1 4 1 4 3 a 
e c 4 6 c 5 4 5 4 5 4 5 4 7 c 6 
