9 5 1 5 1 5 1 5 1 3 9 3 9 5 1 7 
e 9 6 9 6 9 6 9 6 a a a a d 0 7 
9 6 9 6 9 6 9 6 b c 6 c 6 d 0 7 
a 9 6 9 6 9 6 b a 9 3 9 3 d 0 7 
8 6 9 6 9 6 b a 8 2 8 6 e 9 0 7 
a 9 6 9 6 9 6 8 2 e 8 7 9 6 8 7 
a a 9 2 9 2 b a e 9 2 9 4 3 a b 
a a a e a e a 8 3 e c 4 5 4 4 6 
a 8 0 3 8 5 2 c 6 d 1 5 3 d 5 3 
8 2 a a 8 3 c 3 b 9 6 9 6 9 3 a 
a a a a a a b c 4 6 9 6 9 6 a a 
a a c 2 a a c 3 b 9 6 9 6 9 6 a 
c 4 5 4 2 a d 0 4 0 5 6 9 6 9 2 
9 5 3 9 4 2 9 6 b c 7 9 6 9 6 a 
a b a c 1 6 a 9 4 3 9 4 1 6 9 6 
e e c 5 6 d 4 6 d 4 6 d 6 d 4 7 
