9 5 5 1 5 5 1 1 5 5 5 1 1 1 5 3 
8 5 5 4 5 5 2 e 9 5 3 a a a b a 
8 5 1 5 1 3 8 5 2 f a a a a e a 
a b a b a a a b c 5 6 a c 4 5 2 
e a e a e a e 8 5 1 5 0 5 5 5 2 
9 4 1 4 1 6 d 2 d 4 7 a 9 5 3 a 
a b a b a b 9 4 1 1 3 a a f a a 
a a e a e a a 9 2 a c 2 c 1 6 a 
c 4 1 4 5 6 a c 6 a 9 4 7 8 5 2 
9 5 4 5 5 3 c 5 5 6 e d 5 4 1 2 
a 9 5 5 1 2 b 9 5 7 9 5 5 3 a a 
e c 5 3 a 8 2 a d 5 2 d 5 2 a a 
9 5 5 2 8 2 e 8 5 7 8 5 7 a 8 2 
a 9 5 6 a 8 5 2 d 5 2 d 5 2 a a 
a c 5 1 6 a b 8 5 7 8 5 7 a a a 
e d 5 4 5 6 c 4 5 5 6 d 5 4 4 6 
