9 5 5 5 5 5 5 3 9 5 5 5 5 5 5 3 
a 9 5 3 9 1 3 c 6 9 3 9 5 5 3 a 
a c 3 a a e c 5 5 6 c 4 5 7 a a 
a 9 2 8 2 9 5 5 3 d 5 5 3 9 6 a 
a a c 6 8 6 9 5 4 5 5 3 c 2 9 6 
a 8 1 3 e 9 6 9 5 5 3 c 3 a c 3 
a e a c 3 c 1 4 5 3 8 3 a 8 7 a 
a 9 2 b 8 7 e 9 3 a a a a c 3 a 
a a a a 8 5 3 c 4 4 2 a a b a a 
a a a a a b c 5 5 3 c 2 a a a a 
a a a a c 0 1 5 3 c 3 8 6 a a a 
a e 8 6 9 6 c 5 4 3 c 2 9 4 2 a 
8 3 8 1 6 9 5 5 7 c 7 e a d 4 6 
a a a e 9 4 5 5 5 5 5 5 4 3 9 3 
a a c 5 6 9 1 5 3 9 5 1 7 c 6 a 
e c 5 5 5 6 e d 4 6 d 4 5 5 5 6 
