9 3 b d 5 5 5 1 5 5 5 5 7 9 5 3 
a a 8 5 5 1 5 4 1 1 1 5 7 a b a 
a a a 9 5 4 5 7 a a 8 5 5 4 2 a 
8 2 a 8 3 9 5 5 2 e 8 5 5 5 2 a 
a a 8 2 a e 9 7 8 1 0 5 5 7 a a 
8 2 e 8 6 9 4 5 2 e a d 3 b 8 2 
a a d 0 5 4 5 7 c 5 4 5 6 8 6 a 
a c 5 4 5 5 7 9 1 5 5 5 5 0 5 6 
a b d 1 5 5 7 c 6 d 5 5 5 0 5 3 
8 2 d 0 5 1 5 7 9 5 1 5 3 8 3 a 
a a b 8 3 c 1 5 2 b a d 6 e 8 2 
8 2 8 2 a b c 7 8 4 0 5 5 7 a a 
a a a 8 6 c 5 5 2 b 8 5 5 5 2 a 
a 8 2 c 5 1 5 7 a a 8 5 5 1 2 a 
a a 8 5 5 4 5 1 4 4 4 5 7 a e a 
e e e d 5 5 5 4 5 5 5 5 7 c 5 6 
