9 5 5 5 5 5 5 5 5 5 5 5 5 5 5 3 
a 9 5 5 5 5 5 5 1 5 5 5 5 5 3 a 
a a 9 5 5 5 5 5 0 5 1 5 5 3 a a 
a a a 9 5 1 3 d 4 5 2 d 3 a a a 
a c 6 a 9 2 c 5 1 5 4 3 a a 8 2 
c 1 3 8 2 8 5 5 0 5 3 a a a a a 
9 2 c 6 a a 9 5 4 3 a a a a a a 
a 8 3 b a c 2 9 3 a 8 0 2 a a a 
8 2 a 8 2 9 0 4 6 a a a a a 8 2 
a a a a a a e 9 5 6 a a 8 2 a a 
a a a a 8 2 d 4 5 5 4 2 a a a a 
a 8 0 0 2 c 5 5 1 5 5 2 a a a a 
8 2 a a c 5 5 5 4 5 5 0 6 a 8 2 
a a a c 3 b d 5 1 5 5 2 d 6 a a 
a a c 5 4 4 5 5 4 5 3 c 3 d 2 a 
e c 5 5 5 5 5 5 5 5 4 5 4 5 4 6 
