b 9 5 1 5 5 5 1 5 5 5 7 9 1 5 3 
a a f a 9 5 5 4 1 5 5 1 6 c 3 a 
a 8 5 0 6 9 5 7 a 9 5 4 5 3 a a 
8 6 9 2 b a d 5 2 8 5 5 5 4 2 a 
a 9 6 a a 8 5 5 4 4 5 5 5 7 a a 
a a b a a a 9 5 3 9 3 9 3 9 2 a 
a a e a a a 8 5 4 2 a a a a 8 2 
a 8 5 4 6 e a 9 3 a c 2 c 6 a a 
a 8 5 5 5 7 8 4 6 e b c 1 5 2 a 
8 0 5 1 5 7 c 5 7 9 2 b a b 8 2 
a 8 3 c 3 b 9 5 7 a a a a a a a 
a a c 3 a a a d 5 2 a 8 2 a a a 
a a b a a a 8 5 3 a a a a a a a 
a a a a 8 6 a f a a a a a a a a 
a a a a c 1 4 7 c 6 8 4 4 6 c 6 
e c 6 c 5 4 5 5 5 5 4 5 5 5 5 7 
