9 5 1 1 5 7 9 1 1 5 1 5 1 5 1 3 
8 1 2 c 5 5 2 e 8 1 0 7 c 3 a a 
a a c 1 5 5 6 b a e e b 9 6 8 2 
a c 3 c 1 5 1 6 a 9 1 4 6 9 2 a 
a 9 0 5 4 3 c 3 a a c 5 1 2 a a 
a e a d 3 c 3 e 8 6 b 9 6 8 0 6 
a 9 6 b 8 1 2 d 6 b 8 6 9 2 8 3 
c 0 5 6 a a a 9 1 4 4 5 6 e e a 
d 2 b b 8 2 a c 6 d 5 1 5 5 7 a 
b 8 0 0 2 8 2 b d 5 1 4 3 9 1 6 
8 2 e e e e e a 9 7 c 3 c 2 a b 
a 8 5 1 5 3 b a a 9 3 c 3 e 8 2 
a a d 0 7 8 6 e 8 6 8 5 6 9 6 a 
8 6 d 0 7 8 1 5 2 d 0 3 9 4 7 a 
a 9 5 0 5 2 e f a b e 8 6 9 3 a 
e c 7 c 5 4 5 5 4 4 5 4 5 6 c 6 
