9 5 5 3 d 1 5 5 5 5 1 5 1 5 1 3 
8 5 1 6 f a 9 5 5 3 a d 6 9 6 a 
a 9 4 5 3 a a 9 3 a a 9 5 4 3 a 
8 6 b f a a a e e a e a f b c 2 
a 9 4 3 8 6 c 7 d 6 b a 9 4 3 a 
8 6 b a e b 9 5 5 3 8 6 a b a a 
a b a c 3 e a f f c 6 9 6 a a a 
a e 8 5 4 3 c 1 3 f 9 4 7 a a a 
8 5 2 9 7 a b c 6 9 2 d 3 a a a 
a f a a d 2 8 5 5 6 8 7 a a c 2 
a b e a f a a 9 5 5 6 f a e 9 2 
a a b a b 8 6 a 9 5 3 b a b a a 
8 2 c 4 6 a 9 6 a f a c 4 6 a a 
a 8 5 5 5 6 a 9 4 5 4 5 5 5 6 a 
a a 9 5 5 5 6 8 5 5 7 b 9 5 3 a 
e c 4 5 5 5 5 4 5 5 5 4 6 f c 6 
