9 5 5 5 5 5 1 5 5 5 5 5 5 5 5 3 
a 9 5 1 7 9 6 9 5 1 7 9 5 3 b a 
a a 9 6 9 6 9 6 9 6 9 6 9 0 2 a 
a a c 5 6 9 6 9 6 9 6 b a e a a 
a c 5 3 9 6 9 6 9 6 9 0 6 9 6 a 
a d 1 6 c 3 c 5 6 b a e 9 6 b a 
a 9 6 9 5 6 9 5 5 0 6 9 6 9 2 a 
a c 3 c 5 3 a 9 3 a 9 6 9 6 a a 
a 9 6 9 5 6 a 8 6 a a 9 6 9 6 a 
a c 3 c 5 3 c 4 5 6 8 6 9 6 b a 
a 9 6 9 5 6 d 5 5 5 6 9 6 9 4 2 
a 8 5 4 7 9 5 5 5 5 5 6 9 0 5 2 
a e 9 5 5 6 9 3 9 3 9 3 e c 3 a 
8 3 a 9 3 9 2 a a a a a 9 3 a a 
a a c 6 c 6 e c 6 c 6 c 6 c 6 a 
e c 5 5 5 5 5 5 5 5 5 5 5 5 5 6 
