d 5 5 3 d 5 5 5 1 5 1 5 5 5 3 b 
b d 3 8 3 b b b a b a b b 9 6 a 
8 3 8 6 8 4 4 4 2 c 2 c 4 2 b a 
a c 4 7 8 5 1 1 4 3 a b 9 6 a a 
8 5 7 d 2 b e e d 2 c 4 0 5 2 a 
a b 9 3 c 2 b d 5 4 3 b a 9 6 a 
a 8 2 c 7 e 8 7 d 3 a c 2 8 3 a 
a e c 5 5 5 2 9 1 2 c 5 2 a a a 
8 3 9 5 5 7 a 8 6 a 9 5 4 6 a a 
e a c 5 5 5 4 6 b 8 4 5 5 5 2 a 
9 4 5 5 5 5 7 9 4 2 b b 9 1 2 a 
8 7 b 9 5 1 3 a d 6 c 0 6 a a a 
8 3 8 6 b a a e 9 1 3 c 5 6 a a 
a a c 1 2 a a 9 6 a a d 3 b a a 
a a d 2 8 6 8 6 9 6 c 5 4 4 6 e 
e c 5 6 c 5 4 7 c 5 5 5 5 5 5 7 
