9 5 5 5 5 5 5 5 5 5 5 5 5 5 5 3 
a 9 5 5 5 5 1 1 5 5 5 5 5 5 3 a 
a a 9 5 5 3 a 8 5 5 1 5 5 3 a a 
a a a 9 3 a a a d 5 4 5 3 a 8 6 
a a a a a a a c 5 5 5 1 6 a a b 
a a a a a a a 9 5 5 3 c 5 2 a a 
a a a a a a 8 6 9 1 4 5 3 c 6 a 
a a a a a a a 9 2 a 9 3 a d 1 6 
a c 4 6 a a a c 6 a a a c 3 c 3 
a 9 1 7 a a c 5 5 6 c 4 3 a 9 6 
a a c 5 6 a 9 5 5 1 5 1 6 a c 3 
a 8 3 9 5 6 c 5 5 4 1 4 1 4 1 6 
c 2 8 6 9 5 5 5 5 3 c 1 4 1 4 3 
9 2 a 9 6 9 5 5 3 c 3 c 1 4 1 6 
a a 8 6 d 4 3 9 4 7 c 3 c 5 4 3 
e c 4 5 5 5 6 c 5 5 5 4 5 5 5 6 
