9 1 1 5 1 5 3 9 5 1 1 1 1 5 1 3 
a e a b a b e a b a a a c 1 6 a 
a b c 2 c 0 5 2 8 6 a c 1 6 9 2 
8 4 3 c 1 6 b c 0 5 4 1 6 9 6 a 
a d 4 3 c 1 0 5 2 d 3 e 9 0 5 2 
8 1 3 e b e 8 7 a 9 6 9 6 a d 2 
a e 8 5 4 3 c 5 4 6 9 6 9 4 5 2 
8 7 c 5 5 0 7 9 3 9 6 9 4 3 d 2 
8 3 9 1 3 e 9 4 2 8 7 c 7 8 7 a 
a c 6 a e 9 6 9 6 c 3 d 5 4 1 2 
a 9 1 6 9 6 9 6 9 3 c 3 9 5 2 a 
a a e 9 6 9 6 9 2 c 3 c 6 b c 2 
8 6 9 6 9 6 d 6 8 3 8 7 d 0 5 2 
a d 6 9 6 b b 9 6 e 8 5 3 c 3 e 
8 7 9 6 9 2 c 2 9 1 2 d 4 3 c 3 
e d 4 5 6 c 5 4 6 e c 5 5 4 5 6 
