9 5 5 5 5 5 5 5 5 5 5 5 5 5 1 3 
a 9 5 5 5 5 5 5 5 5 5 5 5 3 8 2 
a a 9 1 5 5 5 5 1 1 1 1 3 a 8 2 
a a c 6 9 3 9 3 c 0 0 0 2 a 8 2 
a c 5 5 2 8 2 8 3 8 0 0 2 a 8 2 
8 1 1 3 c 6 c 6 a 8 0 0 2 a 8 2 
8 0 0 0 1 1 1 7 a 8 0 0 2 a 8 2 
8 0 0 0 0 0 2 9 2 8 0 0 2 a 8 2 
8 0 0 0 0 0 2 c 6 8 0 0 2 a 8 2 
8 0 0 0 0 0 0 1 1 0 0 0 2 a 8 2 
8 0 0 4 4 4 4 0 0 4 4 4 6 a 8 2 
c 4 6 9 3 9 3 c 6 9 3 9 3 a 8 2 
9 5 5 2 8 2 8 5 5 2 8 2 8 6 8 2 
a 9 3 c 6 c 6 9 3 c 6 c 6 9 0 2 
a 8 0 1 1 1 1 0 0 1 1 1 1 0 0 2 
e c 4 4 4 4 4 4 4 4 4 4 4 4 4 6 
