9 3 9 1 5 5 1 1 3 9 3 9 1 5 1 3 
a c 2 c 3 9 6 a a a c 6 8 5 2 a 
8 3 c 3 a c 3 a a a f 9 6 9 4 2 
8 0 3 c 2 d 4 6 8 6 9 6 9 6 f a 
a a 8 5 6 9 5 5 0 7 a 9 2 9 1 6 
8 6 c 1 7 c 5 5 6 9 2 a a a c 3 
a 9 3 c 1 7 9 5 5 2 8 4 2 c 3 a 
a a 8 5 4 7 a 9 3 8 2 9 6 9 6 a 
a c 4 5 5 3 a 8 6 a 8 6 9 6 9 6 
c 5 1 5 1 6 c 4 5 4 6 9 4 3 8 7 
9 3 c 1 4 3 9 3 9 5 3 c 1 6 c 3 
a c 5 4 1 0 2 a 8 5 6 9 4 5 5 6 
a f 9 5 2 a 8 2 8 5 3 c 5 5 1 3 
8 1 2 f a 8 2 a c 3 8 5 1 3 a a 
a a c 5 2 a a c 5 6 a d 6 c 6 a 
e c 5 5 4 6 c 5 5 5 4 5 5 5 5 6 
