9 5 1 7 9 5 1 5 5 5 5 5 5 3 9 3 
a 9 4 1 6 9 6 9 5 5 5 5 5 6 a a 
8 2 9 6 9 6 d 4 5 5 5 5 3 9 2 a 
a 8 6 9 6 9 5 5 5 5 5 5 6 a a a 
8 6 9 6 d 4 5 5 5 5 5 1 7 a a a 
a 9 6 b b b b 9 5 5 5 6 9 6 a a 
8 6 b 8 0 0 0 4 7 9 5 3 a 9 6 a 
8 1 2 a a e e 9 3 c 3 a a c 3 a 
a a a 8 4 5 5 4 6 9 6 a a 9 6 a 
c 0 2 8 1 5 5 5 5 4 7 a a c 3 a 
b a a e e 9 3 9 3 9 3 c 6 9 6 a 
8 2 c 1 5 2 c 6 c 2 a 9 5 0 5 2 
a c 1 0 5 6 9 5 5 2 c 4 1 4 3 a 
8 5 2 c 3 9 4 7 d 4 3 9 4 5 6 a 
a b c 3 c 6 9 5 5 3 c 6 9 5 5 2 
e c 5 4 5 5 4 7 d 4 5 5 4 7 d 6 
