b 9 1 1 3 9 5 1 3 9 5 1 3 9 5 3 
c 6 a a c 6 b a c 6 b a c 6 b a 
9 3 a e 9 3 a e 9 3 a e 9 3 a e 
a 8 4 5 2 8 4 5 2 8 4 5 2 8 4 7 
a 8 5 7 a 8 5 7 a 8 5 7 a 8 5 7 
c 4 3 9 4 4 3 9 4 4 3 9 4 4 3 b 
b 9 6 c 3 9 6 c 3 9 6 c 3 9 6 a 
a c 5 5 2 8 5 1 2 c 5 5 2 8 5 6 
a 9 1 5 2 8 1 4 2 9 1 5 2 8 1 3 
c 6 a b e e a b e e a b c 6 a a 
9 3 e a 9 3 e a 9 3 e a 9 3 e a 
a 8 5 4 2 8 5 4 2 8 5 4 2 8 5 6 
a 8 5 7 a 8 5 7 a 8 5 7 a 8 5 7 
c 4 3 9 4 4 3 9 4 4 3 9 4 4 3 b 
9 1 6 c 1 1 6 c 1 1 6 c 1 1 6 a 
e c 5 5 6 c 5 5 6 c 5 5 6 c 5 6 
