9 1 1 1 1 1 1 1 1 1 1 1 1 1 1 3 
8 0 0 0 0 0 0 0 0 0 0 0 0 0 0 2 
8 0 0 0 0 0 0 0 0 0 0 0 0 0 0 2 
8 0 0 0 0 0 0 0 0 0 0 0 0 0 0 2 
8 0 0 0 0 0 0 0 0 0 0 0 0 0 0 2 
8 0 0 0 0 0 0 0 0 0 0 0 0 0 0 2 
8 0 0 0 0 0 0 0 0 0 0 0 0 0 0 2 
8 0 0 0 0 0 0 0 0 0 0 0 0 0 0 2 
8 0 0 0 0 0 0 0 0 0 0 0 0 0 0 2 
8 0 0 0 0 0 0 0 0 0 0 0 0 0 0 2 
c 4 4 4 4 4 4 4 4 4 0 0 0 0 0 2 
9 3 9 1 5 5 5 5 5 3 8 0 0 0 0 2 
a c 6 c 7 9 1 5 7 a 8 0 0 0 0 2 
a 9 1 3 9 2 8 3 b a 8 0 0 0 0 2 
a a a 8 2 8 2 8 2 a 8 0 0 0 0 2 
e c 4 6 c 6 c 6 c 6 c 4 4 4 4 6 
