9 1 1 1 1 1 1 1 1 1 1 1 1 1 1 3 
8 0 0 0 0 0 0 0 0 0 0 0 0 0 0 2 
8 0 0 0 0 0 0 0 0 0 0 0 0 0 0 2 
8 0 0 0 0 0 0 0 0 0 0 0 0 0 0 2 
8 0 0 0 0 0 0 0 0 0 0 0 0 0 0 2 
8 0 0 0 0 0 0 0 0 0 0 0 0 0 0 2 
8 0 0 0 0 0 0 0 0 0 0 0 0 0 0 2 
8 0 0 0 0 0 0 0 0 0 0 0 0 0 0 2 
8 0 0 0 0 0 0 0 0 0 0 0 0 0 0 2 
8 0 0 0 0 0 0 0 0 0 0 0 0 0 0 2 
c 4 4 4 4 4 4 4 4 4 0 0 0 0 0 2 
9 3 9 1 5 5 5 1 1 3 8 0 0 0 0 2 
a c 6 c 3 9 5 4 4 2 8 0 0 0 0 2 
a 9 1 7 c 6 9 5 5 6 8 0 0 0 0 2 
a a 8 1 5 3 c 5 5 3 8 0 0 0 0 2 
e c 6 c 5 4 5 5 5 6 c 4 4 4 4 6 
