9 5 1 3 9 5 5 5 5 5 5 7 d 5 1 3 
8 3 a a a d 1 5 5 5 5 3 9 3 a a 
a a a a c 7 8 1 5 5 5 4 6 a a a 
a a a 8 5 5 6 c 3 9 5 5 5 2 a a 
a a a 8 5 1 1 3 8 2 9 5 7 a a a 
8 2 a 8 3 e a a a c 0 5 5 2 8 2 
e a 8 6 c 3 a e c 5 4 1 7 a e a 
9 2 8 3 9 6 a 9 3 9 3 c 3 c 3 a 
e 8 6 8 4 3 a 8 6 a c 1 4 3 a a 
9 4 5 4 5 6 a c 3 a b c 3 c 2 a 
8 5 5 3 9 1 4 3 c 6 c 3 c 5 2 a 
8 7 d 2 a c 5 0 7 b 9 6 b 9 4 2 
a 9 1 2 8 5 5 4 1 6 8 7 8 6 b a 
a e a e c 5 1 3 c 1 2 9 4 1 2 a 
a 9 4 5 5 5 6 c 5 2 e c 7 e e a 
e c 5 5 5 5 5 5 5 4 5 5 5 5 5 6 
