9 3 9 3 9 3 9 5 5 3 9 5 1 3 9 3 
a c 2 a a 8 2 d 7 8 2 b a 8 6 a 
c 3 a 8 2 a c 5 5 6 a 8 2 8 1 6 
9 6 a e e c 1 5 5 1 6 a a a c 3 
a 9 4 5 5 3 a d 7 a 9 4 4 4 3 a 
a a 9 5 3 a c 5 5 6 a 9 5 3 a a 
8 2 a f a a 9 5 5 3 a a f a a a 
a a c 5 6 a a 9 3 8 6 c 5 6 a a 
a c 5 5 5 6 c 4 6 e d 5 5 1 6 a 
8 5 5 5 5 1 5 5 5 5 1 5 3 c 5 2 
8 5 1 3 f a f f f f a f a 9 3 a 
a f a a b c 5 5 5 5 6 b a a a a 
8 5 6 a e f f 9 3 f f e a a 8 2 
8 5 5 2 d 1 5 6 c 5 1 5 6 a e a 
a f b 8 5 6 9 5 5 3 c 5 1 2 f a 
e d 4 4 5 5 6 d 7 c 5 5 6 c 5 6 
