b b 9 5 5 5 5 5 5 1 5 1 3 d 5 7 
e 8 4 5 5 7 d 1 3 c 7 a c 5 5 3 
b a 9 5 5 5 1 6 a 9 7 e 9 5 5 2 
8 4 6 9 5 5 4 7 c 4 5 3 e d 3 a 
8 5 3 c 5 1 5 1 5 5 7 8 5 5 6 a 
c 3 c 1 5 6 9 6 9 1 5 6 9 5 3 a 
9 2 9 2 9 3 c 7 e c 5 5 2 b 8 6 
a c 6 c 2 8 3 9 3 f 9 7 8 6 a b 
a 9 5 3 a a e c 4 5 0 1 6 d 2 a 
a 8 3 a c 4 5 3 d 7 e c 3 d 0 2 
a e a c 3 9 3 a d 5 1 5 6 b a a 
a d 0 7 8 2 e a b d 4 3 d 4 4 2 
c 5 0 5 2 c 3 a a d 5 4 3 d 3 a 
9 5 2 d 4 7 8 6 c 3 9 5 4 7 a a 
a b c 3 d 1 2 9 1 6 c 5 1 5 2 a 
e e d 4 5 6 c 6 c 5 5 5 4 7 c 6 
