f d 7 9 1 7 b 9 5 5 5 5 5 5 5 3 
9 1 5 6 8 5 0 6 9 1 5 3 9 5 1 6 
8 6 f f 8 5 2 b a a b a 8 5 0 7 
c 5 1 3 8 5 2 e c 0 6 a c 5 2 b 
f b a a a b a b b a f c 5 5 6 e 
9 4 4 6 c 4 6 a a 8 5 5 1 5 1 3 
a 9 1 3 9 1 3 e e c 5 5 4 5 6 a 
a a a a a a a 9 1 5 5 5 5 5 5 6 
c 4 4 4 4 4 2 c 6 9 5 5 1 5 5 3 
9 5 3 9 5 3 8 7 9 2 9 5 2 d 7 e 
8 5 2 a f a c 5 4 6 a f a 9 5 3 
8 5 2 8 5 4 1 5 7 f c 5 4 4 5 2 
8 5 2 8 5 3 a 9 5 3 9 5 3 f d 2 
8 5 2 8 7 a a 8 5 2 8 1 2 9 5 6 
8 5 4 4 1 6 a a b a a a a a b b 
e d 5 5 6 f c 6 e c 4 4 4 6 c 6 
