9 3 9 5 5 5 5 5 5 5 3 d 1 5 1 3 
a a a 9 5 5 5 3 b 9 4 5 4 1 6 a 
a a a a d 1 7 c 4 0 5 5 1 6 b a 
a a a c 5 0 5 1 3 8 3 9 4 7 8 2 
a a a b 9 4 1 6 a a c 0 7 9 6 a 
a a 8 2 c 5 4 1 2 c 5 6 9 6 9 2 
a a a 8 5 5 3 e c 1 7 9 6 f a a 
a a a 8 1 7 e 9 1 6 9 2 9 5 4 2 
a a a a e 9 3 c 6 9 2 a a b f a 
a a 8 6 9 6 8 7 9 6 a a a 8 5 2 
a 8 2 9 6 9 6 9 2 9 4 4 4 6 f a 
a a 8 6 9 6 9 6 a a 9 5 5 5 5 2 
a a a 9 6 9 6 f a a c 5 5 3 9 6 
a e 8 6 9 6 9 5 2 8 5 5 3 8 4 3 
8 3 e 9 6 d 4 7 a a d 7 8 6 9 6 
e c 5 4 5 5 5 5 4 4 5 5 6 d 6 f 
