9 5 1 5 1 1 5 3 9 5 5 5 5 5 5 3 
a 9 6 9 2 8 5 4 4 5 5 3 9 5 3 a 
8 6 9 6 a c 1 5 5 5 5 6 c 3 8 2 
8 1 6 9 2 9 6 d 5 5 5 5 3 8 6 a 
a e 9 6 8 6 9 5 5 5 5 3 8 2 b a 
a b a 9 2 d 6 9 5 5 3 8 2 a a a 
a a a a 8 5 3 c 5 3 8 6 a a a a 
c 2 a a a 9 6 9 3 a a b a a 8 6 
9 2 a a a a 9 4 6 8 6 a a a 8 3 
a a a a a a c 5 5 6 9 6 a a a a 
a a a a a c 1 5 7 9 4 3 c 6 a a 
a a a a c 1 4 5 5 6 9 6 9 5 2 a 
a a a c 5 4 5 5 5 1 6 9 6 9 6 a 
a 8 4 5 5 5 5 5 5 4 5 6 9 6 d 2 
a c 5 5 5 5 5 1 1 5 5 5 6 9 1 6 
e d 5 5 5 5 5 6 c 5 5 5 5 6 c 7 
