d 1 1 5 1 3 9 1 7 9 5 5 5 5 3 b 
d 6 8 3 a c 2 c 1 6 b b 9 5 2 a 
9 1 2 8 4 1 6 9 6 9 4 2 a d 4 2 
a a c 2 b e 9 6 9 4 7 8 4 1 5 2 
8 6 9 6 8 1 4 5 6 d 5 2 9 4 3 a 
a 9 6 9 2 c 5 1 1 5 5 0 0 5 6 a 
a c 1 2 c 1 1 6 e d 3 a 8 5 5 6 
a 9 6 8 1 6 8 1 3 9 2 a a d 3 b 
a c 1 6 c 3 a c 4 6 a c 0 7 8 2 
a b a d 3 c 4 3 9 5 4 3 8 5 6 a 
a c 6 d 0 5 3 c 4 1 3 8 4 5 5 2 
a d 5 5 0 5 4 5 3 e a c 1 5 1 2 
8 5 5 5 0 5 5 5 0 3 c 5 2 b a a 
8 3 b b c 1 5 5 6 8 5 3 e 8 2 a 
a 8 2 8 5 4 7 d 5 0 5 0 5 2 e e 
e e e c 5 5 5 5 7 e f c 5 4 5 7 
