9 5 1 5 3 b 9 5 5 5 5 7 d 3 d 3 
a d 2 b a 8 6 9 7 9 5 5 1 4 5 2 
8 7 a a a a 9 2 9 6 9 5 2 b b a 
e 9 6 a a a e 8 6 9 6 9 0 6 a a 
9 6 9 6 a a 9 6 9 6 9 6 e 9 6 a 
a d 4 5 2 8 6 b a 9 2 b 9 0 1 6 
a 9 1 3 a a 9 6 e a e c 6 a c 3 
a a a 8 2 e a 9 1 6 d 1 7 8 5 2 
8 6 e a c 5 2 c 6 b b a b e 9 2 
a 9 5 4 5 3 c 5 5 4 4 4 4 5 6 a 
e a 9 5 3 a 9 5 5 5 5 5 5 5 1 2 
9 6 a b a a 8 5 5 5 5 5 5 3 a a 
a b a a c 2 a 9 5 5 5 5 5 6 a a 
a 8 4 4 5 6 a c 5 5 5 5 5 3 a a 
a a b d 5 5 4 5 5 5 5 5 7 a a a 
e c 4 5 5 5 5 5 5 5 5 5 5 6 c 6 
