d 3 d 5 1 5 5 1 3 d 1 5 5 5 3 b 
b c 3 9 6 9 3 a c 7 8 1 5 7 a a 
a d 4 2 9 6 a 8 7 b a a 9 3 8 6 
8 7 d 0 6 d 6 8 5 4 6 a c 6 8 7 
8 5 5 0 5 1 5 6 d 5 1 4 5 5 4 7 
a 9 5 6 d 4 1 3 b 9 6 b b d 3 b 
a 8 5 5 3 f a e 8 2 9 4 0 5 6 a 
a 8 5 3 c 5 6 9 2 a c 3 8 5 5 2 
e a d 4 1 5 3 8 6 e 9 4 6 9 5 2 
9 4 1 1 6 d 6 8 5 3 a b 9 6 d 2 
a 9 6 a 9 5 5 4 3 8 6 8 6 b d 2 
8 6 9 2 c 3 9 3 e e 9 6 9 6 d 2 
8 5 6 a 9 6 a 8 5 7 c 1 4 1 5 2 
8 3 9 6 a 9 2 8 3 b b c 3 c 3 a 
a a 8 3 e e a a 8 6 8 7 c 3 e e 
e c 6 c 5 5 4 4 4 5 4 5 5 4 5 7 
