b b 9 1 5 1 7 d 5 5 5 5 1 5 5 3 
8 4 2 c 3 c 1 3 9 5 3 9 4 3 9 2 
c 3 c 5 2 9 6 8 6 9 6 e d 0 6 a 
9 6 9 5 6 a b e 9 6 9 5 1 6 b a 
c 3 c 5 5 0 2 9 6 9 6 9 6 b a a 
9 6 9 1 7 a c 4 1 6 9 6 9 2 a a 
c 3 a e b c 1 7 e 9 6 9 6 a a a 
9 6 8 3 8 3 a 9 3 c 5 6 9 6 a a 
c 3 e a e a a c 4 5 5 5 6 b a a 
d 0 5 2 9 6 e d 1 5 3 9 7 a a a 
b 8 7 8 6 9 5 1 4 1 0 4 5 2 a a 
c 2 9 4 3 a 9 4 1 2 a 9 5 6 a a 
b a 8 5 2 8 4 1 2 8 2 c 5 3 a a 
8 2 c 3 a c 1 2 8 6 a 9 5 6 a a 
a a 9 4 0 5 6 8 4 5 4 4 5 5 6 a 
e c 6 f c 5 5 4 5 5 5 5 5 5 5 6 
