9 5 5 1 5 5 5 3 9 7 d 3 b 9 5 3 
c 3 b c 3 d 5 0 6 9 1 4 4 4 3 a 
9 4 4 5 4 3 9 2 9 6 a d 3 9 2 a 
a f b 9 5 2 a c 4 3 c 1 4 6 a a 
a b 8 0 5 6 c 3 d 6 d 6 b f a a 
a a c 2 d 5 7 8 5 7 d 5 4 5 6 a 
a a b 8 5 5 5 4 5 5 5 3 b d 7 a 
a 8 6 a d 1 7 9 3 d 5 6 c 5 5 2 
a c 3 c 5 4 5 4 6 d 1 3 b d 3 a 
a b 8 5 1 5 7 9 5 3 a 8 4 3 8 2 
e c 6 b 8 3 d 6 b c 2 a b a a a 
b b d 6 a c 5 5 4 7 8 6 8 6 a a 
8 4 1 5 2 d 1 1 1 5 2 b a 9 2 a 
a b a d 6 9 6 a e f a a a e a a 
a a 8 3 b e 9 6 9 5 6 a 8 5 4 2 
e e e c 4 5 4 7 c 5 5 4 4 5 5 6 
