9 5 1 5 5 5 1 5 5 5 5 5 5 5 5 3 
c 3 8 5 5 1 4 3 9 5 5 5 5 5 5 2 
9 6 8 5 1 4 5 6 c 5 5 5 5 1 7 a 
c 3 a 9 6 9 5 5 5 5 5 5 5 6 b a 
9 6 8 2 b a 9 5 5 5 1 1 3 9 2 a 
c 3 a e a c 2 9 1 5 2 a a a a a 
d 6 c 5 4 7 c 6 c 7 a a a a a a 
9 3 9 5 5 7 9 1 3 d 2 c 2 a a a 
a a a d 3 b a c 6 d 0 7 a a a a 
e a 8 7 c 6 8 5 3 f 8 7 c 6 a a 
9 6 e d 5 5 4 3 a f a 9 5 5 6 a 
a d 5 1 3 9 5 4 2 f a 8 5 5 5 2 
8 1 3 c 6 8 3 b e d 2 8 7 9 3 a 
e a 8 7 d 6 a a f d 6 e 9 6 a a 
9 2 a 9 3 9 6 a b b 9 5 6 9 6 a 
e e c 6 c 6 f c 6 c 6 d 5 4 5 6 
