b 9 5 5 5 7 9 5 5 5 5 5 5 7 9 3 
a a 9 5 5 1 4 5 1 5 1 5 5 3 a a 
a 8 2 9 5 6 d 7 a b 8 5 3 a a a 
8 2 8 2 d 5 1 1 2 e 8 3 e e a a 
a 8 2 c 5 5 2 a 8 5 2 c 3 9 0 2 
a a a d 5 7 e e e f c 3 a a a a 
a a 8 5 5 3 9 5 5 3 f a 8 6 a a 
a e c 5 5 6 8 1 3 8 5 4 4 7 c 6 
a b 9 5 5 3 a c 6 8 5 1 1 3 9 3 
a a 8 5 5 6 c 5 5 6 f a a a a a 
a a a d 5 7 b b b f b a a 8 2 a 
a 8 2 9 5 5 2 a 8 5 6 c 2 e 8 2 
8 2 8 2 d 5 4 4 0 3 f 9 4 7 a a 
a 8 2 8 5 5 5 7 a c 5 4 5 7 a a 
a a c 4 5 5 1 5 4 5 5 5 5 7 a a 
e c 5 5 5 7 c 5 5 5 5 5 5 7 c 6 
