9 5 5 5 5 1 7 9 5 5 5 5 5 5 5 3 
a 9 1 5 7 c 3 a 9 3 9 3 9 5 5 2 
c 6 a 9 5 3 a 8 6 c 6 a a 9 3 a 
9 5 6 a b c 4 4 5 5 3 a a a a a 
a 9 5 6 8 1 5 5 5 5 2 a a a a a 
a a 9 5 2 a 9 5 5 3 a a a a a a 
a a c 3 a e 8 5 5 6 c 2 a e a a 
a c 1 4 2 9 2 9 1 5 3 e c 3 a a 
c 3 c 5 6 a a c 6 b c 5 5 6 a a 
9 6 9 5 3 a a 9 5 2 9 5 3 9 6 a 
a 9 4 3 c 4 2 c 3 a c 3 a c 3 a 
a a 9 2 9 3 8 5 6 a 9 6 c 5 6 a 
c 6 a a a c 4 5 3 a c 5 3 9 5 6 
9 5 6 a a 9 5 3 a c 5 3 a a 9 3 
8 1 5 6 a c 3 a c 5 3 c 6 8 6 a 
e c 5 5 4 5 6 c 5 7 c 5 5 4 5 6 
