b 9 5 5 1 5 5 5 7 9 5 5 5 5 5 3 
a 8 3 d 4 1 7 9 5 4 5 3 d 5 5 2 
a a 8 1 7 8 3 c 5 5 3 8 5 5 7 a 
8 4 6 c 5 6 c 5 5 3 e 8 5 5 1 6 
8 5 1 5 5 7 9 5 5 4 5 4 5 7 8 3 
a d 4 1 5 7 c 5 5 5 5 7 9 1 2 a 
a 9 5 4 1 7 9 5 5 3 9 5 2 a e a 
a 8 5 7 c 3 a 9 3 a a b a 8 5 2 
a a d 5 1 6 c 4 6 8 2 a c 4 3 a 
a 8 7 9 6 9 5 5 1 6 e 8 5 5 2 a 
a a d 4 3 a 9 5 4 1 1 4 5 7 a a 
a c 5 1 4 4 4 5 5 2 a d 5 5 4 2 
8 1 3 e b b 9 1 7 e c 5 5 5 7 a 
a a c 5 2 a a a d 3 9 5 5 5 1 6 
a 8 5 5 0 2 e 8 5 4 4 1 5 7 c 3 
e c 5 5 6 c 5 4 5 5 7 c 5 5 5 6 
