9 1 5 1 5 1 1 5 1 5 5 1 5 5 1 7 
a e 9 6 9 6 a d 0 7 9 4 1 5 4 3 
a 9 6 9 6 d 4 5 0 7 c 1 4 1 5 2 
8 6 9 6 9 5 3 d 0 7 9 4 5 4 3 a 
a 9 6 9 2 9 2 d 0 7 8 5 1 5 4 2 
8 6 9 6 e a a d 0 5 2 b a 9 5 2 
a 9 6 9 5 6 8 7 c 1 0 6 a c 3 a 
8 4 7 a 9 3 a 9 3 a e 9 0 3 a a 
c 5 5 6 a a c 4 6 e 9 2 a a a a 
d 5 5 1 4 4 5 1 7 9 6 e a a a a 
d 5 1 4 5 5 1 6 9 6 9 5 6 a a a 
9 5 4 5 1 5 6 9 4 7 a 9 5 2 a a 
a 9 5 3 8 1 1 0 5 5 6 a d 2 a a 
a 8 5 4 2 e a c 5 5 5 4 5 6 a a 
8 2 d 5 4 5 4 5 5 5 5 5 5 5 6 a 
e c 5 5 5 5 5 5 5 5 5 5 5 5 5 6 
