9 5 5 5 5 5 5 5 5 5 5 5 1 5 1 7 
8 3 9 5 5 5 5 5 5 5 3 d 4 5 0 3 
a a 8 5 5 5 5 5 5 5 4 5 5 3 a a 
a a 8 3 b 9 5 5 5 5 5 1 3 a a a 
a a a a a a 9 1 5 5 3 a a a 8 2 
8 6 8 0 2 a a 8 5 5 0 4 6 8 6 a 
a b a a a a a c 5 1 2 9 5 6 b a 
a a a a a a a 9 3 a a 8 3 b a a 
a a 8 4 4 6 a c 2 c 6 a 8 2 a e 
a a e 9 5 3 8 5 4 5 3 a a c 2 b 
a a b a 9 2 c 1 5 1 6 c 4 3 8 2 
a 8 2 8 6 a d 4 1 6 9 5 5 4 6 a 
c 6 c 6 9 6 d 1 6 d 4 5 5 1 7 a 
9 5 5 1 4 3 d 4 1 5 5 3 d 4 1 2 
a 9 5 4 5 4 5 3 8 5 5 4 5 5 6 a 
e c 5 5 5 5 5 6 c 5 5 5 5 5 5 6 
