9 1 1 1 1 1 1 1 1 1 1 1 1 1 1 3 
8 0 0 0 0 0 0 0 0 0 0 0 0 0 0 2 
8 0 0 0 0 0 0 0 0 0 0 0 0 0 0 2 
8 0 0 0 0 0 0 0 0 0 0 0 0 0 0 2 
8 0 0 0 0 0 0 0 0 0 0 0 0 0 0 2 
8 0 0 0 0 0 0 0 0 0 0 0 0 0 0 2 
8 0 0 0 0 0 0 4 4 0 0 0 0 0 0 2 
8 0 0 0 0 0 6 9 3 8 0 0 0 0 0 2 
8 0 0 0 0 6 9 4 6 8 0 0 0 0 0 2 
8 0 0 0 6 9 6 9 1 0 0 0 0 0 0 2 
8 0 0 6 9 6 9 0 0 0 0 0 0 0 0 2 
8 0 6 9 6 9 0 0 0 0 0 0 0 0 0 2 
8 6 9 6 9 0 0 0 0 0 0 0 0 0 0 2 
e 9 6 9 0 0 0 0 0 0 0 0 0 0 0 2 
9 6 9 0 0 0 0 0 0 0 0 0 0 0 0 2 
e d 4 4 4 4 4 4 4 4 4 4 4 4 4 6 
