9 5 5 5 1 7 d 5 5 1 5 5 5 5 5 3 
a 9 5 1 4 1 1 5 1 4 1 5 1 5 3 a 
a 8 7 a d 6 e d 6 d 6 f e b c 2 
a c 1 6 d 3 b d 1 7 9 7 b e b a 
a 9 6 d 3 c 4 1 4 1 4 1 4 5 2 a 
a a 9 5 2 d 5 0 3 a b 8 3 b a a 
8 0 4 3 a b 9 6 e a 8 2 a 8 0 2 
a c 1 4 4 2 a 9 3 a a e 8 2 a a 
8 5 0 7 d 2 a 8 6 c 4 1 6 e a a 
8 5 0 7 d 2 a a d 5 5 4 5 1 2 a 
a d 0 7 9 6 a a 9 5 1 1 1 2 a a 
a d 0 7 a b c 2 8 1 6 a a a a a 
8 5 0 3 8 4 3 e a a b 8 0 2 a a 
a b a a 8 3 c 3 c 0 4 6 a e a a 
a a a e a a b a d 0 5 5 4 5 4 2 
e c 4 5 4 4 4 4 5 4 7 d 5 5 5 6 
