9 5 1 5 5 5 5 5 1 5 5 5 1 5 1 7 
8 5 0 7 9 3 d 1 4 3 d 5 4 3 8 7 
8 5 0 7 a 8 3 c 7 c 3 b b e 8 7 
8 5 0 5 0 6 a 9 5 3 8 4 0 3 a b 
8 5 0 7 a 9 2 a 9 6 8 5 2 c 0 6 
a 9 0 5 4 6 8 6 8 7 8 1 6 b c 3 
8 6 8 7 9 3 c 5 6 9 2 a 9 0 7 a 
a 9 6 9 6 8 3 9 3 e 8 6 a c 3 a 
a a 9 6 9 2 8 4 6 b e d 0 7 c 2 
8 2 c 3 e c 6 9 1 2 b b a d 5 2 
a a d 4 1 5 7 e a 8 2 c 0 7 9 2 
8 6 9 7 a 9 1 7 8 2 a d 0 7 a e 
8 1 4 3 a a 8 5 2 8 2 9 0 7 c 3 
a 8 7 a a a 8 3 c 6 c 6 c 1 7 a 
8 2 9 2 a a e 8 1 1 5 1 5 0 7 a 
e c 6 e c 6 d 6 e c 5 4 5 6 d 6 
