9 5 5 5 1 5 5 3 9 5 5 5 5 5 5 3 
a b d 5 0 5 7 c 6 d 5 5 5 5 1 2 
a a b d 4 1 5 5 1 5 5 5 7 9 6 a 
a a a b 9 6 d 5 4 5 5 7 9 2 b a 
a a a 8 6 d 5 1 1 5 7 9 2 c 0 2 
a 8 0 6 9 1 5 6 c 5 1 6 c 1 2 a 
c 2 a 9 6 a 9 5 5 3 a b 9 2 a a 
9 6 a c 5 4 6 9 3 a c 0 6 a a a 
a d 0 7 9 3 9 4 6 8 1 0 1 0 2 a 
a d 0 7 a 8 6 9 5 6 a a a a 8 2 
a 9 0 7 a c 5 2 9 5 6 e e e a e 
a e 8 7 c 5 5 4 4 5 7 d 5 1 0 3 
a d 0 7 9 3 d 3 b 9 1 7 b a a a 
a 9 4 1 6 c 5 6 8 2 a b a e a a 
a 8 5 4 5 5 5 1 2 8 2 a a d 6 a 
e c 5 5 5 5 5 6 e e c 4 4 5 5 6 
