9 5 5 5 5 1 5 5 1 5 1 5 5 5 5 7 
a 9 5 5 3 a 9 3 a b a d 3 b d 3 
a a d 3 a a a a a a a b c 2 d 6 
8 0 5 6 a a c 2 a a a a b c 1 3 
a a 9 3 a a 9 4 6 a 8 6 8 5 6 a 
a e e a a a c 3 d 0 6 9 6 b 9 6 
c 1 5 6 a 8 3 c 5 0 7 a 9 6 c 3 
d 4 5 3 a a a 9 3 c 5 4 4 3 9 6 
9 3 9 6 e c 6 c 2 d 1 1 7 a c 3 
a a c 5 1 3 d 5 4 3 a 8 3 a 9 6 
a a 9 5 6 a 9 5 3 8 6 a a a c 3 
c 4 2 9 3 e c 5 2 a b a a e b a 
9 5 6 a 8 5 5 7 a e a c 4 5 4 6 
c 5 5 4 4 5 5 5 4 5 0 5 5 5 5 3 
9 3 9 3 9 3 9 3 9 3 8 3 9 3 d 2 
e c 6 c 6 c 6 c 6 c 6 c 6 c 5 6 
