9 1 5 5 5 5 5 5 5 5 5 5 5 5 5 3 
a c 3 d 1 5 5 1 7 9 5 5 5 5 5 2 
a 9 6 9 0 7 9 6 d 0 7 9 3 9 3 a 
a 8 7 a e d 0 7 9 6 9 2 a a a a 
a a d 0 7 9 6 9 6 b a e a a a a 
a a 9 6 9 6 d 0 7 a a d 0 2 a a 
a a a d 0 7 9 6 d 2 c 3 e e a a 
a 8 6 9 6 9 6 9 1 2 d 0 7 9 6 a 
a e 9 6 d 0 7 c 6 a 9 6 9 6 9 2 
a 9 0 7 9 6 9 3 b a a d 2 9 6 a 
a a e d 0 7 a a c 0 6 9 6 c 3 a 
a 8 7 9 6 9 6 8 1 6 d 4 3 9 6 a 
a c 5 0 7 c 3 e c 3 9 5 6 c 3 a 
8 3 9 6 d 5 0 7 d 6 c 5 5 5 6 a 
a a c 5 5 5 4 5 5 5 5 5 5 5 7 a 
e c 5 5 5 5 5 5 5 5 5 5 5 5 5 6 
