9 5 5 5 3 9 5 5 5 5 5 5 5 5 5 3 
a 9 3 9 2 a 9 5 5 1 5 5 5 5 1 2 
8 2 8 6 a a a 9 3 a 9 1 5 5 6 a 
a 8 0 3 a a a c 6 a a a d 5 1 2 
a a a a a a 8 5 5 6 a a 9 5 2 a 
a a a a c 6 c 3 9 5 0 6 c 3 a a 
a a a c 5 5 5 6 8 5 6 9 5 6 a a 
a a a 9 3 9 3 9 2 9 5 2 9 3 a a 
a 8 2 c 6 a a c 6 a 9 2 c 6 a a 
a a 8 3 9 0 0 5 5 4 2 8 3 9 2 a 
a a a a a a 8 5 5 5 2 a a a a a 
a a a a a a a 9 3 9 2 a a a a a 
8 2 c 4 6 a a c 6 a a c 4 6 a a 
a 8 5 5 5 6 a 9 5 4 4 5 5 5 6 a 
a a 9 5 5 5 6 a 9 5 1 3 9 5 5 2 
e c 4 5 5 5 5 4 4 5 6 c 4 5 5 6 
