9 5 5 5 5 1 5 5 5 5 5 5 5 7 9 3 
a 9 5 5 5 4 5 5 5 5 5 5 5 5 2 a 
a a b d 1 1 3 9 1 3 9 5 1 3 a a 
a a c 1 2 a a a a c 6 b e a a a 
8 2 9 6 e e c 6 a 9 3 a 9 2 a a 
a a c 5 5 1 1 7 a a a a a e a a 
a a 9 5 7 a a 9 6 8 0 4 6 b a a 
a a 8 5 7 c 2 8 3 a c 7 b a a a 
a a c 5 1 3 a c 6 a b 9 2 a e a 
a a 9 5 6 8 4 7 9 6 c 2 c 2 9 2 
a a 8 5 1 6 b d 4 5 3 8 3 8 2 a 
a a 8 3 8 3 8 5 5 5 6 e c 2 a a 
a a a a e 8 0 5 7 9 5 5 1 6 a a 
a a e c 7 e c 5 5 6 d 5 4 5 6 a 
a 8 5 5 5 5 5 5 3 d 5 5 5 5 5 2 
e c 5 5 5 5 7 d 4 5 5 5 5 5 7 e 
