b 9 5 5 5 5 3 d 7 9 5 5 5 5 5 3 
a 8 5 5 5 3 c 5 5 6 9 5 5 5 3 a 
a a 9 5 7 c 5 3 9 5 6 d 5 3 8 2 
8 2 a 9 5 5 3 a a 9 5 5 3 a a a 
a a e a f b a 8 2 a b f a e 8 2 
a c 5 2 d 6 a a a a c 7 8 5 6 a 
c 3 f c 1 5 6 c 6 8 5 5 6 f 9 6 
b a d 5 4 5 3 9 3 c 5 5 5 3 a b 
e a d 1 5 5 6 c 4 5 5 5 5 6 a e 
9 6 f c 5 5 3 9 3 9 5 5 3 f c 3 
a 9 5 3 d 3 a a a a 9 7 8 5 3 a 
8 2 b a f e a 8 2 a e f a b a a 
a a a c 5 1 6 a a c 1 5 6 a 8 2 
a a c 5 7 8 5 6 c 5 2 d 5 6 a a 
a 8 5 5 5 6 9 5 5 3 c 5 5 5 6 a 
e c 5 5 5 5 6 d 7 c 5 5 5 5 5 6 
