9 5 5 5 1 5 5 1 5 5 5 1 5 7 9 3 
8 5 3 b 8 3 b a 9 5 3 8 3 9 6 a 
a 9 6 8 2 c 6 a c 3 a a c 6 9 2 
8 2 9 2 e 9 3 c 5 6 a c 5 5 6 a 
e 8 2 e 9 6 8 5 5 3 c 5 5 5 5 2 
9 2 e 9 4 3 a 9 5 4 5 3 9 5 5 2 
a e 9 6 b a a c 5 1 7 a 8 5 3 a 
a 9 2 9 2 a a 9 3 a 9 6 c 3 a a 
a a c 2 8 6 c 4 6 8 6 9 3 a a a 
a c 3 a c 1 7 9 3 a 9 6 c 6 a a 
c 3 a c 3 a 9 6 a a a 9 5 5 6 a 
9 6 c 3 a a a 9 6 a a a 9 5 5 2 
a 9 3 a a e a 8 5 6 a a a 9 7 a 
8 2 a a c 5 6 a 9 5 6 a a c 5 6 
a a a c 5 1 5 6 c 5 5 2 c 5 5 3 
e c 6 d 5 4 5 5 5 5 5 4 5 5 5 6 
