9 5 1 5 1 5 5 5 1 5 5 5 1 5 5 3 
a b a b a b 9 7 a d 5 7 8 3 f a 
a a a a a a a f a d 1 1 6 c 3 a 
a a e a e a a d 6 f a c 3 9 4 2 
c 4 5 4 5 0 4 5 3 9 2 f c 2 b a 
9 5 5 1 5 4 5 5 6 a c 1 1 4 2 a 
a 9 7 e d 5 3 9 5 4 1 6 e f e a 
8 4 5 1 5 5 2 8 3 9 6 b 9 5 5 2 
c 5 5 0 5 5 2 c 6 e b a e f b a 
9 1 5 4 5 3 c 1 1 3 a 8 5 5 6 a 
a 8 5 5 3 c 3 a a a 8 0 5 5 7 a 
e a d 7 c 3 8 2 a e a a d 5 5 2 
d 4 5 3 b a a 8 2 d 2 8 5 5 7 a 
9 5 5 2 a a a a a b a a d 5 5 2 
a d 7 a e a a a 8 6 a 8 5 5 7 a 
e d 5 4 5 4 6 c 4 5 6 c 5 5 5 6 
