b 9 1 5 5 1 7 d 1 5 1 7 d 1 1 7 
a e 8 3 d 0 7 d 0 7 8 5 5 6 a b 
a 9 6 c 3 8 7 d 0 7 c 7 d 3 c 2 
a c 3 b 8 0 5 5 0 7 d 5 5 4 5 2 
8 3 c 2 e c 3 d 2 9 1 1 5 1 5 2 
a a b c 3 b 8 3 a a a a d 2 d 2 
a c 2 9 4 2 e c 6 a a a d 0 7 a 
8 1 6 c 3 c 3 9 3 a c 4 1 4 1 2 
a a d 1 4 3 a 8 6 a d 5 6 b e a 
a 8 7 a b 8 6 c 5 6 b b 9 4 3 a 
a 8 1 0 4 2 9 7 b d 0 0 4 7 a a 
a a e a d 2 8 5 4 5 2 c 5 5 2 a 
a 8 5 4 5 2 c 3 d 5 4 5 1 5 6 a 
8 4 5 1 7 e b a b d 3 9 6 b b a 
a 9 5 4 7 d 4 4 4 5 2 8 7 8 2 a 
e c 5 5 5 5 5 5 5 5 6 c 5 6 c 6 
