9 1 1 1 1 1 1 1 1 1 1 1 1 1 1 3 
8 0 0 0 0 0 0 0 0 0 0 0 0 0 0 2 
8 0 0 0 0 0 0 0 0 0 0 0 0 0 0 2 
8 0 0 0 0 0 0 0 0 0 0 0 0 0 0 2 
8 0 0 0 0 0 0 0 0 0 0 0 0 0 0 2 
c 4 4 4 4 4 4 4 4 0 0 0 0 0 0 2 
9 5 5 5 1 3 9 5 3 8 0 0 0 0 0 2 
a 9 5 5 6 a a 9 2 8 0 0 0 0 0 2 
a 8 5 5 1 4 2 c 2 8 0 0 0 0 0 2 
a c 1 3 8 3 8 5 2 8 0 0 0 0 0 2 
8 3 a a a c 4 5 6 8 0 0 0 0 0 2 
e a 8 0 6 9 1 1 1 0 0 0 0 0 0 2 
b a a 8 3 8 0 0 0 0 0 0 0 0 0 2 
8 6 a a a 8 0 0 0 0 0 0 0 0 0 2 
8 3 c 4 2 8 0 0 0 0 0 0 0 0 0 2 
e c 5 5 6 c 4 4 4 4 4 4 4 4 4 6 
