9 5 1 5 1 7 9 5 3 d 5 5 1 1 5 3 
e 9 6 9 6 9 6 9 6 9 5 5 2 e b a 
9 6 9 6 9 6 9 6 9 6 9 7 e b c 2 
a 9 6 9 6 9 6 9 6 9 6 b b c 1 2 
a a 9 6 9 6 9 6 9 6 9 2 c 1 2 a 
a 8 6 9 6 9 6 9 2 b a c 1 2 a a 
a e 9 6 9 6 9 6 a a c 1 2 a a a 
a 9 6 9 6 9 2 9 2 c 1 2 a a a a 
a a 9 6 9 6 e 8 6 9 2 a a a a a 
a c 6 9 6 f 9 6 9 2 a a a a a a 
8 7 9 6 f 9 6 9 6 a a a a a a a 
a 9 6 f 9 6 9 4 5 6 a a a a a a 
a a f 9 6 9 4 5 5 5 6 c 6 a a a 
a a 9 6 9 4 5 5 5 5 5 5 5 6 a a 
a 8 6 9 4 5 5 5 5 5 5 5 5 5 6 a 
e c 5 4 5 5 5 5 5 5 5 5 5 5 5 6 
