9 5 5 5 5 5 5 5 5 5 5 5 5 5 5 3 
8 5 3 d 1 5 1 5 1 5 5 5 5 1 1 2 
c 1 4 3 c 3 c 3 a 9 5 5 3 e e e 
9 4 3 c 3 c 3 c 6 a 9 5 4 7 d 3 
c 1 6 9 4 7 c 3 9 6 a b 9 3 9 2 
d 0 7 c 5 3 b c 6 9 6 8 6 c 6 a 
d 0 7 d 1 4 2 b d 2 d 0 7 9 5 6 
d 0 7 9 4 1 6 8 3 8 7 a d 2 9 3 
d 0 7 c 1 6 b 8 4 6 9 0 7 c 6 a 
d 0 7 9 4 3 c 0 1 5 6 e 9 3 9 2 
9 4 1 4 1 4 7 e e 9 3 d 2 c 6 e 
c 1 4 1 4 7 9 3 9 2 a d 4 5 1 7 
9 4 1 4 7 9 6 c 2 a c 5 5 3 c 3 
c 1 4 3 9 4 3 9 4 2 9 3 9 2 b a 
9 0 1 6 8 1 2 8 3 8 2 8 2 8 2 a 
e e c 5 6 e c 6 c 6 c 6 c 6 c 6 
