b b d 5 1 5 5 3 b b b b 9 5 3 b 
c 0 5 5 0 5 1 4 2 8 2 8 0 5 0 2 
d 2 d 5 0 1 4 5 0 2 8 2 c 1 6 a 
b 8 5 5 6 a 9 5 2 a a 8 1 4 5 2 
8 4 5 5 7 a c 1 4 0 4 2 c 1 3 a 
8 5 5 1 7 e d 2 b 8 5 0 5 6 a a 
a 9 5 4 3 d 5 4 4 0 5 4 1 1 0 6 
a c 5 5 6 d 5 1 3 8 5 5 2 a c 3 
a 9 1 5 5 5 1 4 0 4 1 5 6 c 5 2 
a a a d 5 5 2 b c 3 c 5 5 1 1 2 
a e e d 5 5 4 4 1 2 9 5 1 2 a a 
e d 1 5 5 5 5 3 a c 0 5 2 8 6 a 
9 5 4 1 5 5 1 4 0 5 0 5 6 a 9 6 
8 5 5 6 9 5 6 b c 5 0 1 1 0 4 3 
8 1 5 5 0 1 7 8 1 1 2 a a c 3 e 
e c 5 5 6 c 5 6 e e c 6 c 5 4 7 
