9 3 9 1 1 3 9 3 d 1 5 5 3 9 3 b 
a c 6 a a a a a 9 6 9 3 c 6 c 2 
a 9 5 6 a a a c 6 9 6 c 5 1 5 6 
a a d 1 4 6 a b 9 6 9 5 5 6 9 3 
a a d 2 9 5 6 8 6 d 0 5 3 d 2 a 
a a d 2 a d 1 6 9 5 4 5 2 d 2 a 
a a d 0 6 9 6 9 4 3 9 5 4 5 6 a 
8 6 9 6 9 6 b 8 3 a c 5 5 5 3 a 
a 9 6 9 6 d 2 c 6 a d 5 1 5 6 a 
a 8 5 6 9 7 c 5 5 4 5 5 0 5 5 6 
a 8 3 9 0 5 7 9 3 9 3 9 2 9 7 b 
a a c 6 8 5 7 a c 6 c 6 8 4 1 6 
a a 9 7 c 3 9 6 9 3 9 3 8 3 c 3 
a 8 4 5 3 8 0 5 6 c 6 c 6 c 3 a 
a 8 1 5 4 6 a 9 5 5 5 5 5 5 6 a 
e e c 5 7 d 4 4 5 5 5 5 5 5 5 6 
