9 5 1 5 5 5 5 1 5 5 5 5 1 5 5 3 
a f a 9 5 5 3 a 9 5 5 5 0 5 5 2 
8 5 2 a d 7 a a a 9 5 3 a 9 7 a 
a b a 8 5 1 6 a a a b a a a d 2 
a a a a b e d 2 a a e a a c 3 a 
a e a e 8 3 f e a c 5 6 8 7 a a 
8 5 0 5 6 c 5 7 c 5 3 d 2 d 6 a 
a b e 9 5 5 3 9 3 9 6 d 4 5 1 2 
8 4 1 0 5 1 6 c 2 a 9 5 5 7 a a 
e b e a b a 9 3 c 6 a d 5 5 2 a 
b 8 5 6 a e a 8 3 d 0 5 5 7 a a 
8 4 1 5 4 5 2 a c 3 a d 5 5 4 2 
c 7 a 9 5 1 2 8 3 a 8 3 d 1 5 2 
9 5 2 8 1 6 8 6 a e a c 1 6 9 2 
a b 8 2 e d 4 1 4 5 4 5 2 9 6 a 
e c 6 c 5 5 5 4 5 5 5 5 4 4 5 6 
