9 5 5 5 5 5 5 5 5 5 5 5 1 1 5 3 
a d 5 5 1 5 1 1 3 b b b a 8 7 a 
c 5 5 3 8 7 a a 8 4 4 0 4 4 3 a 
9 1 5 6 a d 4 4 4 1 5 2 d 1 6 a 
a a d 5 4 5 5 5 5 6 b a 9 4 3 a 
c 0 7 d 5 1 3 d 1 5 0 4 0 3 c 2 
9 0 5 5 3 e 8 5 6 9 2 9 6 8 3 a 
e 8 5 3 c 3 e 9 3 e a a d 6 a a 
9 4 3 c 3 c 3 c 4 5 6 e 9 3 a a 
c 3 a b c 3 c 3 d 1 5 5 6 c 2 a 
9 0 0 4 1 4 5 4 3 c 1 5 1 7 a a 
a e e b c 3 9 3 c 3 c 3 8 7 a a 
8 5 1 0 3 a a 8 3 c 3 c 2 d 2 a 
a b e e a 8 2 a 8 3 c 3 c 3 a a 
a 8 5 5 2 a c 2 a c 3 c 3 a e a 
e c 5 5 6 c 5 4 4 5 4 5 4 4 5 6 
