9 1 1 5 1 5 3 9 7 b d 5 5 5 1 3 
a e c 1 6 9 2 a 9 4 3 b 9 3 a a 
a 9 7 a 9 2 c 4 6 b a a a e a a 
a a d 0 2 e d 1 3 a a a c 5 6 a 
8 4 5 2 c 5 7 e a a 8 4 7 d 5 2 
8 5 1 6 d 1 7 d 2 a 8 5 5 5 7 a 
a d 4 1 5 2 d 5 4 4 4 5 3 d 5 6 
8 5 5 6 b c 7 9 3 9 7 9 6 9 5 3 
8 5 7 9 4 5 7 8 6 8 1 4 5 4 5 2 
8 5 3 8 7 b 9 6 9 2 8 1 5 5 5 2 
8 5 4 6 9 6 8 3 a a a 8 5 5 1 6 
a 9 7 9 6 b a 8 2 a a 8 5 5 4 3 
8 4 3 c 7 a a e 8 2 c 4 5 5 5 2 
e 9 2 d 3 a a d 2 8 1 5 1 5 1 2 
9 6 8 5 4 6 e d 6 e e b c 5 2 a 
e d 4 5 5 5 5 5 5 5 5 4 5 5 6 e 
