b d 1 5 3 9 3 9 5 1 5 5 5 5 5 3 
a d 0 7 c 6 8 6 9 2 9 5 1 3 d 2 
a d 0 5 5 3 e 9 6 a 8 5 2 8 5 2 
a d 0 5 3 e 9 2 b a 8 5 4 6 d 2 
a 9 4 7 e 9 6 e a a a 9 5 3 d 2 
8 4 5 7 9 6 9 5 2 e a c 5 4 5 2 
c 5 3 9 4 3 a d 4 3 8 5 5 5 7 a 
9 5 6 8 5 6 a 9 3 c 4 5 5 5 5 2 
8 5 3 8 5 3 a c 4 3 9 5 5 5 7 a 
a 9 6 c 1 6 8 5 3 a a 9 5 5 5 6 
a 8 5 7 c 3 c 3 e a a c 5 5 1 7 
a c 1 7 b c 3 c 3 a 8 5 5 7 c 3 
a d 0 5 6 b c 3 c 6 a d 1 5 5 6 
a d 0 5 5 6 b c 1 5 0 3 c 1 5 3 
a d 0 7 9 3 8 3 c 3 a c 3 c 3 e 
e d 4 5 6 c 6 c 5 6 c 7 c 5 4 7 
