9 5 5 5 5 5 5 5 3 9 3 9 1 5 5 3 
a 9 5 5 5 1 7 b a a c 2 c 5 3 a 
e 8 5 1 5 2 d 2 a c 5 2 d 1 6 a 
b c 3 8 1 0 5 4 4 5 3 c 3 c 3 a 
8 3 8 2 a c 5 3 b b 8 5 6 b a a 
a c 6 c 6 9 3 a c 4 4 5 7 8 6 e 
8 5 3 b d 2 8 4 5 5 5 1 5 0 1 3 
8 5 4 6 9 0 4 1 3 b d 0 3 a e a 
a b 9 3 a 8 7 8 6 a 9 6 a a 9 2 
c 4 6 a c 0 5 4 3 c 6 b a a a a 
9 5 5 2 d 0 7 d 2 9 5 4 4 6 a e 
a 9 3 c 7 e 9 5 2 c 7 9 5 5 0 3 
a a c 3 9 3 a 9 4 5 5 4 5 7 a a 
a c 3 c 6 c 6 c 5 5 5 5 5 1 2 a 
8 1 6 9 3 9 5 5 5 5 5 5 5 6 e a 
e c 5 6 c 4 5 5 5 5 5 5 5 5 5 6 
