9 5 1 5 5 5 1 5 5 5 5 5 5 5 5 3 
c 3 8 5 5 1 4 3 9 5 5 5 5 5 5 2 
9 6 8 5 1 4 5 6 c 5 5 5 5 1 7 a 
c 3 a 9 6 9 5 5 5 5 5 5 5 6 b a 
9 6 8 2 b a 9 5 5 5 1 1 3 9 2 a 
c 3 a e a c 2 9 1 5 2 a a a a a 
9 6 8 5 4 7 c 6 c 7 a a a a a a 
8 3 8 5 5 5 3 9 3 d 2 c 2 a a a 
a a a d 3 9 6 c 2 d 0 7 a a a a 
e a c 7 8 2 d 5 0 7 8 7 c 6 a a 
9 2 b 9 2 c 3 d 0 7 a 9 5 5 6 a 
a a 8 2 8 1 6 d 0 7 a 8 5 5 5 2 
8 4 2 a a c 3 d 0 5 2 8 7 9 3 a 
a 9 6 a 8 5 6 b c 5 6 e 9 6 a a 
a c 1 6 8 3 9 2 9 3 9 5 6 9 6 a 
e d 4 5 6 c 6 c 6 c 6 d 5 4 5 6 
