9 5 5 3 9 5 5 5 5 5 5 1 5 5 7 b 
c 5 3 8 6 9 1 5 5 3 b c 5 3 9 6 
9 5 6 a d 6 a b 9 4 4 1 5 6 c 3 
a 9 3 a 9 5 2 a c 5 7 a 9 5 3 a 
a a a a 8 5 6 8 5 5 3 a 8 1 6 a 
a a c 6 a 9 5 4 1 3 a a a a b a 
a a 9 5 6 c 1 7 a a a c 6 a c 2 
a a c 5 1 3 a 9 2 a c 3 b a d 2 
a c 5 5 2 a a c 6 8 3 c 6 a d 2 
8 3 9 3 8 2 8 5 5 6 8 3 d 0 5 2 
a a a a a a c 5 3 9 2 8 3 c 7 a 
a a a a 8 4 5 3 c 6 c 6 8 1 5 2 
a c 6 a a d 3 c 5 5 5 3 e 8 3 a 
a 9 5 6 c 7 c 5 5 5 5 4 3 a a a 
a a 9 3 9 3 9 3 9 3 9 3 c 4 6 a 
e c 6 c 6 c 6 c 6 c 6 c 5 5 5 6 
