9 5 1 7 9 5 5 3 9 1 5 5 1 5 5 3 
a d 0 5 4 5 7 e a 8 7 d 0 7 9 6 
a d 0 7 9 3 9 3 a e b d 0 7 c 3 
a d 4 5 6 c 6 a a 9 2 d 0 7 d 2 
c 5 5 5 5 3 9 6 a a 8 5 6 9 7 a 
9 3 9 1 5 6 a 9 6 a 8 5 5 6 f a 
a c 6 e d 5 4 6 9 6 e b d 3 9 2 
c 5 5 1 5 5 7 9 2 9 5 4 5 4 6 e 
9 1 3 8 3 9 3 c 6 c 1 3 9 3 9 3 
a a a a a a a b b b e c 6 c 6 a 
a a a e c 6 c 2 a c 5 1 5 3 d 2 
a a a d 1 5 3 a a 9 3 c 3 c 3 a 
a a a 9 6 f c 6 a a c 3 c 3 c 2 
a a 8 6 9 5 3 9 0 2 b c 3 c 3 e 
a a e 9 6 9 6 a a e c 5 2 f c 3 
e c 5 6 d 4 5 6 c 5 5 7 c 5 5 6 
