9 5 5 5 5 5 5 5 5 5 5 5 5 1 1 3 
a 9 5 5 5 5 5 5 5 5 5 5 5 2 a a 
a a 9 5 5 1 5 5 5 3 b 9 3 a a a 
a c 6 9 5 4 5 5 7 a a a a a a a 
a b 9 6 9 3 9 5 5 2 a a a a a a 
a 8 6 9 6 a a 9 5 2 a a a a a a 
a 8 5 6 9 6 a c 7 e 8 2 a a a a 
8 0 5 5 4 7 a 9 1 5 2 a a a a a 
a 8 3 9 5 3 a c 6 9 2 a a a a a 
a a c 6 9 6 8 3 9 6 a a a a a a 
a 8 1 3 c 3 a c 6 9 6 a a a a a 
a a a 8 3 a c 5 1 2 b a 8 4 2 a 
a a a a e c 5 5 6 c 6 e a 9 6 a 
a a a c 5 5 5 5 5 5 5 5 6 c 1 6 
a a c 5 5 5 5 5 5 5 5 5 5 5 4 3 
e c 5 5 5 5 5 5 5 5 5 5 5 5 5 6 
