b 9 5 5 5 5 7 9 5 5 5 5 5 5 5 7 
a a d 5 5 5 5 0 5 5 5 1 5 5 5 3 
a 8 1 5 5 5 7 a 9 5 7 8 5 5 7 a 
a a 8 1 5 5 1 0 0 3 9 6 9 5 1 2 
8 2 a c 1 5 2 a a 8 2 f 8 3 a a 
a a e 9 2 f a c 2 a c 3 a a c 2 
a 8 1 2 c 7 c 5 6 e f c 2 8 1 2 
a a a 8 5 3 9 1 3 b 9 3 a a a e 
a a a c 5 6 a c 6 a a a 8 4 4 3 
a a c 3 9 3 a 9 1 2 e a a d 7 a 
a a b 8 6 a 8 6 a c 1 4 0 1 1 6 
a 8 2 e d 2 c 5 4 5 4 7 a a a b 
a a 8 1 7 c 1 5 5 5 7 9 4 4 4 2 
a a a c 1 3 c 1 5 5 1 4 1 5 7 a 
a a a f a 8 5 2 d 5 6 f c 5 5 6 
e e c 5 6 c 7 c 5 5 5 5 5 5 5 7 
