9 5 5 3 d 7 d 1 5 5 5 5 1 5 1 3 
a b 9 0 1 5 5 0 5 1 7 d 4 3 a a 
a c 2 a c 5 5 4 3 8 3 d 1 6 a a 
a 9 6 c 3 9 3 9 2 a 8 5 4 3 a a 
c 4 5 5 0 2 8 6 c 6 a b d 4 4 2 
9 5 5 5 2 8 6 d 1 5 6 8 1 7 b a 
a 9 5 5 0 6 9 5 4 5 5 2 c 1 4 2 
a c 5 1 6 f c 1 3 d 7 8 1 6 f a 
c 5 1 4 5 5 7 c 6 d 5 6 c 7 d 2 
9 3 8 5 7 9 5 5 5 1 1 5 5 5 5 2 
a 8 0 5 5 4 1 5 5 2 c 3 d 1 5 2 
a 8 6 9 5 3 a 9 5 2 d 4 3 c 5 2 
a a d 0 3 8 6 c 5 0 3 9 4 3 d 2 
a 8 5 6 e 8 1 3 b a e c 1 4 3 a 
a a 9 5 7 a e a a 8 1 5 4 7 8 6 
e e c 5 5 4 5 4 4 6 c 5 5 5 4 7 
