b 9 3 9 5 5 1 5 3 b 9 5 5 5 5 3 
8 6 8 4 5 1 4 3 8 2 a 9 5 5 3 a 
a 9 4 5 1 4 3 c 2 a a a d 5 6 a 
a c 1 7 e b c 5 2 8 2 c 5 5 5 6 
8 3 c 5 5 4 5 3 c 2 c 5 5 5 5 3 
a 8 5 5 7 9 5 4 7 c 3 d 5 1 5 6 
a a d 5 5 2 9 1 5 3 c 1 5 4 1 7 
a 8 5 5 7 a a 8 3 a b c 1 1 4 3 
a a d 5 5 2 a c 6 a 8 3 a c 3 a 
c 4 1 5 7 c 0 5 5 6 a a c 3 8 2 
9 1 4 1 5 3 c 1 5 1 6 8 7 8 2 a 
e a d 2 b a b a b a b a d 2 a a 
d 4 3 8 4 2 a a a a a a b a 8 6 
9 5 4 2 9 0 2 e a e a c 2 8 4 3 
a 9 7 8 6 a 8 5 4 5 4 3 c 6 9 6 
e c 5 4 5 6 c 5 5 5 5 4 5 5 4 7 
