b 9 3 9 1 5 5 5 5 7 9 5 5 5 1 3 
a a a e 8 5 1 5 5 5 4 1 5 7 a a 
8 2 8 1 2 f 8 5 5 3 d 0 5 5 2 a 
a a a a 8 5 6 9 3 8 5 2 9 5 6 a 
a 8 4 2 8 5 7 e c 2 d 0 4 5 5 2 
8 4 3 8 6 9 5 5 5 4 7 e 9 5 5 6 
a b 8 4 1 4 1 5 5 5 5 7 8 7 9 3 
a e e f e f e 9 1 5 5 1 4 5 6 a 
a b b f b f b c 6 d 5 4 1 5 3 a 
a e 8 1 4 1 4 5 5 5 5 7 8 7 c 6 
8 1 6 8 3 c 5 5 5 1 7 b c 5 5 3 
a a 9 2 8 5 7 b 9 2 d 0 1 5 5 2 
a 8 2 a 8 5 3 c 6 8 5 2 c 5 3 a 
a a 8 4 2 f 8 5 5 6 d 0 5 5 2 a 
a a a b 8 5 4 5 5 5 1 4 5 7 a a 
e c 6 c 4 5 5 5 5 7 c 5 5 5 4 6 
