b 9 3 9 3 9 3 b 9 5 5 5 5 5 5 3 
a a a a a a a a c 1 5 1 7 9 5 6 
a a a a a a a a 9 6 d 0 7 c 5 3 
a a a a a a a a c 3 d 0 7 9 5 6 
a a a a a a a a 9 6 d 0 7 c 5 3 
8 6 c 6 c 6 c 4 4 3 d 0 7 9 5 6 
a d 1 1 7 9 5 5 5 2 d 0 7 c 5 3 
a d 2 8 3 8 3 9 3 a d 0 7 9 5 6 
a b 8 6 c 2 a 8 6 e d 0 7 c 5 3 
a 8 4 5 5 2 a c 3 d 5 0 7 9 5 6 
a 8 5 5 5 0 4 3 a 9 5 0 7 c 5 3 
a c 5 5 3 a f a a c 3 8 7 9 5 6 
a d 5 5 6 c 5 6 a 9 6 8 7 c 5 3 
a 9 5 5 5 5 5 5 6 8 7 8 7 9 5 6 
a 8 5 5 5 5 5 5 5 4 7 8 3 c 5 3 
e c 5 5 5 5 5 5 5 5 5 4 4 5 5 6 
