9 5 5 5 5 5 5 5 5 5 5 5 5 5 5 3 
a 9 5 5 5 5 5 5 5 5 5 5 5 5 5 2 
a c 5 5 5 5 5 5 5 1 5 5 5 7 b a 
c 5 3 d 5 5 5 5 5 0 5 5 5 5 6 a 
b b 8 5 5 1 5 5 7 8 1 5 1 1 3 a 
a a a d 5 2 d 5 1 2 a 9 6 a a a 
c 4 4 1 1 4 1 7 a a a c 5 2 a a 
9 1 5 6 8 3 a 9 2 a c 5 5 0 6 a 
e a 9 5 2 8 6 c 6 a b b b e b a 
b a a b c 2 9 5 3 c 4 4 4 5 2 a 
8 4 0 4 5 6 8 7 8 1 7 9 1 1 4 2 
a 9 0 7 9 7 8 7 a e 9 6 a 8 5 2 
a a c 1 4 7 8 7 8 7 8 7 8 4 3 e 
a a b c 3 d 2 9 4 3 8 7 a f c 3 
a c 2 b 8 3 8 4 3 a 8 7 c 3 b a 
e d 4 4 6 c 4 5 6 c 4 5 7 c 6 e 
