9 5 5 5 5 5 5 5 5 5 5 5 5 5 1 3 
a 9 5 5 5 5 5 5 5 5 1 5 5 3 a a 
a a 9 5 5 5 5 5 5 3 a 9 3 a a a 
a c 6 9 5 5 5 5 5 6 a a a a a a 
a b 9 6 9 3 9 5 5 3 a a a a a a 
a 8 6 9 6 a a 9 5 2 a a a a a a 
a c 5 6 9 6 a c 7 8 6 a a a a a 
8 5 5 3 c 3 8 1 3 a b a a a a a 
a 9 3 c 5 6 a c 6 a 8 6 a a a a 
a a c 5 1 7 c 3 9 6 c 3 a a a a 
a c 5 3 c 3 9 4 4 5 3 a a a a a 
a 9 3 c 3 a c 5 1 3 a a a a a a 
c 2 a 9 6 c 5 5 6 c 6 a a a e a 
9 2 a c 5 5 5 5 5 5 5 6 a c 5 6 
a a c 5 5 5 5 5 5 5 5 5 4 5 5 3 
e c 5 5 5 5 5 5 5 5 5 5 5 5 5 6 
