9 5 5 5 5 1 5 5 5 5 5 5 5 5 5 3 
8 5 5 3 b c 7 9 5 3 9 5 5 5 3 a 
c 5 3 c 0 7 9 6 9 6 c 5 3 9 6 a 
9 5 6 d 4 5 6 9 6 9 5 5 6 c 3 a 
c 5 5 5 3 d 1 4 7 c 5 3 9 5 6 a 
9 3 9 5 6 9 4 5 7 9 5 6 a 9 3 a 
a c 6 d 1 6 9 5 3 c 5 3 a a a a 
a d 5 1 4 7 a 9 2 9 5 6 a a a a 
a d 1 4 7 d 2 c 6 a 9 3 a a 8 2 
a 9 4 5 5 3 8 5 5 6 a c 2 a a a 
a c 5 5 7 a c 5 5 3 c 3 e a a a 
8 5 1 3 b a 9 5 3 c 3 c 3 a a a 
c 1 2 a a a c 3 c 3 c 3 c 6 a a 
9 2 8 6 a c 3 c 3 c 3 c 3 9 6 e 
a 8 4 5 4 7 c 5 4 7 c 5 6 c 5 3 
e c 5 5 5 5 5 5 5 5 5 5 5 5 5 6 
