9 1 3 9 1 1 1 7 9 5 5 5 1 5 1 3 
a a a a a a 8 7 a 9 5 1 6 b a a 
a a a 8 6 c 0 3 a a 9 6 b 8 2 a 
8 6 c 6 d 3 e a a 8 6 b 8 6 a a 
c 5 3 b d 0 1 2 8 6 9 6 8 5 6 a 
9 5 4 6 b a a a a d 0 5 4 5 5 6 
8 5 1 5 6 a 8 4 6 b a 9 5 7 9 3 
8 5 2 d 1 6 a 9 3 8 6 8 7 9 6 a 
8 5 4 3 c 1 6 c 4 6 9 2 9 6 b a 
a 9 5 4 7 e b b b b a 8 6 9 6 a 
c 4 5 5 5 5 4 4 2 a 8 6 9 4 7 a 
9 5 3 b 9 5 5 7 a 8 6 9 4 5 7 a 
a b e a a b d 5 4 6 9 4 5 5 7 a 
8 0 1 0 2 a b 9 5 1 4 5 5 5 7 a 
a a a a e a 8 4 1 4 5 5 5 5 7 a 
e c 4 4 5 4 4 5 4 5 5 5 5 5 5 6 
