9 3 9 3 9 5 5 5 5 5 5 5 5 5 5 3 
a a a a a b 9 3 d 1 5 3 d 1 5 2 
a c 6 c 6 a a c 3 c 3 c 5 6 d 2 
c 3 9 5 5 2 a d 4 3 c 3 d 1 3 a 
9 6 8 5 3 a a 9 5 4 3 c 3 e c 2 
a 9 4 3 a e a a d 1 4 3 c 3 d 2 
c 0 7 e c 7 a e d 2 d 4 3 c 3 a 
9 4 5 5 5 7 e 9 3 e d 1 4 3 a a 
8 5 5 5 5 7 b 8 6 d 5 6 d 2 a a 
8 5 5 5 5 5 6 a 9 7 9 7 9 6 a a 
8 5 1 7 9 5 7 a c 1 6 9 6 9 6 a 
a 9 4 7 8 5 3 a b c 1 6 9 6 b a 
a c 5 5 6 9 6 a 8 5 6 9 6 9 6 a 
8 5 5 5 5 4 7 a c 5 5 6 d 4 3 a 
8 5 5 5 5 5 5 6 b b b b b b a a 
e d 5 5 5 5 5 5 4 4 4 4 4 4 4 6 
