b 9 5 3 9 5 5 3 9 5 5 5 5 1 5 3 
a a b a 8 3 9 4 4 1 5 5 5 2 b a 
a a a a a 8 4 3 f 8 5 5 5 2 a a 
8 2 a 8 2 8 5 0 5 0 5 5 7 a a a 
a a a a a a b a b 8 3 9 1 6 a a 
a a a a 8 2 e a a a a a a b a a 
a 8 0 6 a c 1 4 6 e c 6 8 2 e a 
8 6 c 5 6 b e 9 3 9 5 5 6 c 5 6 
8 3 9 5 3 e b c 4 4 5 5 3 9 5 3 
a 8 0 3 a 9 4 1 3 b 9 3 8 2 b a 
a a a a 8 2 b a a a a a a e a a 
8 2 a a a a e a e 8 6 c 4 3 a a 
a a a 8 2 8 5 0 5 0 5 5 7 a a a 
a a a a a 8 1 6 f 8 5 5 5 2 a a 
a a e a 8 6 c 1 1 4 5 5 5 2 e a 
e c 5 6 c 5 5 6 c 5 5 5 5 4 5 6 
