9 5 5 5 5 5 5 5 5 5 5 5 5 5 5 3 
a 9 3 9 3 9 5 5 5 5 5 5 1 5 1 2 
c 2 c 6 c 6 9 5 5 5 3 9 6 9 6 a 
d 4 3 b b b c 3 9 3 8 6 9 6 b a 
9 3 a 8 0 0 3 a a a a 9 6 9 2 a 
a a a a e e c 6 a a a a 9 6 a a 
a c 6 a 9 5 5 5 6 c 6 c 6 9 6 a 
c 1 3 a a 9 3 9 3 b b b 9 6 9 2 
9 6 a a c 2 a c 4 0 4 2 a 9 6 a 
c 3 a c 3 e 8 7 b c 3 a a c 3 a 
9 6 c 3 8 1 4 5 0 3 a a a 9 6 a 
c 3 b a e c 5 3 e a a 8 6 c 3 a 
9 6 8 6 b b b c 3 a a c 5 5 6 a 
a 9 2 9 0 0 0 3 a a c 5 5 5 3 a 
8 2 8 2 a a a c 2 a 9 5 5 5 6 a 
e c 6 c 4 4 4 5 4 6 c 5 5 5 5 6 
