9 7 9 1 7 9 3 9 1 5 5 5 5 5 5 3 
a 9 6 8 5 2 a e 8 5 5 5 5 5 3 a 
a c 3 a 9 2 c 1 6 9 5 5 5 5 6 a 
8 1 6 c 2 e 9 6 d 4 5 5 5 5 3 a 
a a 9 3 c 5 2 9 1 5 5 1 3 9 6 a 
a 8 2 c 3 d 6 a c 5 5 6 c 4 7 a 
c 2 c 7 c 1 3 a d 3 9 3 9 3 9 2 
9 4 5 5 5 6 a 8 3 a a c 6 c 2 a 
a 9 5 5 5 3 e c 6 a c 5 5 3 e a 
a a 9 5 5 6 9 5 5 4 5 3 9 2 b a 
c 2 a 9 5 5 4 5 5 5 3 a a a a a 
9 2 a a 9 5 5 5 5 5 6 a c 4 2 a 
a a a a c 5 5 5 5 5 1 0 5 5 4 2 
a a a 8 5 5 5 5 5 3 a c 5 5 3 a 
a a c 6 9 1 5 5 5 6 a 9 5 5 6 a 
e c 5 5 6 c 5 5 5 5 4 4 5 5 5 6 
