9 5 5 5 5 5 5 5 5 5 5 5 5 5 5 3 
a 9 5 5 5 5 5 5 5 5 5 5 5 1 7 a 
a a 9 5 1 7 9 5 3 9 3 9 3 c 3 a 
a a a 9 6 d 0 7 a a c 6 a 9 6 a 
a c 6 8 7 9 6 9 6 a 9 5 6 c 3 a 
8 7 9 6 d 0 7 c 5 6 a 9 5 5 6 a 
a d 0 7 9 6 9 5 5 1 6 8 7 9 5 2 
a 9 6 d 0 7 c 1 3 a d 2 d 0 7 a 
a c 3 d 4 5 3 c 6 a 9 6 9 6 9 2 
a d 0 7 d 1 0 7 d 2 a d 0 7 a a 
a b c 5 3 e c 5 3 c 6 9 6 9 6 a 
a 8 7 d 0 7 d 1 0 7 d 0 7 c 3 a 
a c 1 7 c 5 3 e c 3 9 6 9 5 6 a 
8 3 c 5 3 d 0 7 d 4 6 d 4 5 7 e 
a 8 5 5 4 7 c 5 5 5 5 5 5 5 5 3 
e c 5 5 5 5 5 5 5 5 5 5 5 5 5 6 
