9 1 5 5 5 5 5 5 5 5 1 1 1 1 1 3 
a 8 1 1 1 1 1 1 1 1 0 0 0 0 0 2 
a 8 0 0 0 0 0 0 0 0 0 0 0 0 0 2 
a 8 0 0 0 0 0 0 0 0 0 0 0 0 0 2 
a 8 0 0 0 0 0 0 0 0 0 0 0 0 0 2 
a 8 0 0 0 0 0 0 0 0 0 0 0 0 0 2 
a 8 0 0 0 0 0 0 0 0 0 0 0 0 0 2 
a 8 0 0 0 0 0 0 0 0 0 0 0 0 0 2 
a 8 0 0 0 0 0 0 0 0 0 0 0 0 0 2 
a 8 0 0 0 0 0 0 0 0 0 0 0 0 0 2 
a 8 0 0 0 0 0 0 0 0 0 0 0 0 0 2 
a 8 0 0 0 0 0 0 0 0 0 0 0 0 0 2 
a c 4 4 4 4 4 4 4 4 4 4 4 4 4 2 
8 1 1 1 1 1 1 1 1 1 1 1 1 1 1 2 
8 0 0 0 0 0 0 0 0 0 0 0 0 0 0 2 
e c 4 4 4 4 4 4 4 4 4 4 4 4 4 6 
