9 1 1 1 1 1 1 1 1 1 1 1 1 1 1 3 
8 0 0 0 0 0 0 0 0 0 0 0 0 0 0 2 
8 0 0 0 0 0 0 0 0 0 0 0 0 0 0 2 
8 0 0 0 0 0 0 0 0 0 0 0 0 0 0 2 
8 0 0 0 0 0 0 0 0 0 0 0 0 0 0 2 
8 0 0 0 0 0 4 4 4 4 4 4 4 0 0 2 
8 0 0 0 0 2 9 5 5 1 1 1 3 8 0 2 
8 0 0 0 0 2 8 1 3 a a a a 8 0 2 
8 0 0 0 0 2 a c 6 a a a a 8 0 2 
8 0 0 4 4 6 c 5 5 0 4 4 2 8 0 2 
c 4 6 9 3 9 3 9 3 c 5 5 2 8 0 2 
9 5 5 2 8 2 8 2 8 5 5 5 6 8 0 2 
a 9 3 c 6 c 6 c 6 9 1 1 1 0 0 2 
a 8 0 1 1 1 1 1 1 0 0 0 0 0 0 2 
a 8 0 0 0 0 0 0 0 0 0 0 0 0 0 2 
e c 4 4 4 4 4 4 4 4 4 4 4 4 4 6 
