9 1 1 1 1 1 1 1 1 1 1 1 1 1 1 3 
8 0 0 0 0 0 0 0 0 0 0 0 0 0 0 2 
8 0 0 0 0 0 0 0 0 0 0 0 0 0 0 2 
8 0 0 0 0 0 0 0 0 0 0 0 0 0 0 2 
8 0 0 0 0 0 0 0 0 0 0 0 0 0 0 2 
8 0 0 0 0 0 0 0 0 0 0 0 0 0 0 2 
c 4 4 4 4 4 4 4 4 0 0 0 0 0 0 2 
9 1 5 1 5 1 7 9 3 8 0 0 0 0 0 2 
e c 3 c 3 c 5 0 6 8 0 0 0 0 0 2 
9 5 6 d 4 5 7 c 3 8 0 0 0 0 0 2 
8 5 3 9 5 5 5 5 6 8 0 0 0 0 0 2 
8 7 a c 5 1 5 1 3 8 0 0 0 0 0 2 
c 7 a d 5 4 1 6 a 8 0 0 0 0 0 2 
9 1 6 d 5 1 4 3 a 8 0 0 0 0 0 2 
a 8 5 5 5 4 5 4 2 8 0 0 0 0 0 2 
e c 5 5 5 5 5 5 6 c 4 4 4 4 4 6 
