9 5 5 5 5 5 3 9 1 5 1 5 5 5 5 3 
a d 5 5 5 5 6 a 8 3 c 1 7 d 1 2 
a 9 3 9 3 9 1 6 a 8 3 c 3 d 2 a 
a a a a a a 8 7 8 2 c 3 c 3 c 6 
8 2 8 2 8 2 c 3 a 8 3 8 3 c 3 b 
a e e e e c 5 6 c 6 c 6 c 3 c 2 
8 5 5 1 5 1 1 5 7 9 5 5 5 4 1 2 
a b 9 6 d 6 a 9 3 c 5 5 5 5 6 a 
8 2 c 1 5 7 a c 2 9 5 1 1 5 5 2 
a 8 3 e 9 5 4 7 a c 5 6 a b b a 
a e c 3 c 1 5 7 8 1 7 b e a 8 2 
a 9 3 c 3 c 3 b a a b a b 8 2 a 
a a c 5 2 9 6 a e a 8 6 8 2 e a 
a 8 5 5 6 c 5 2 9 4 6 9 2 a 9 2 
a a 9 5 5 5 5 6 a d 1 6 c 4 6 a 
e c 4 7 d 5 5 5 4 5 4 5 5 7 d 6 
