b b 9 7 9 5 5 5 5 5 1 5 7 9 3 b 
a 8 6 9 6 d 5 1 5 7 a 9 5 2 c 2 
c 6 9 6 d 5 5 4 5 7 a a 9 4 7 a 
9 5 2 9 7 9 5 5 5 5 2 a a f d 2 
a b a e 9 6 9 5 1 3 a 8 2 b d 2 
a a e 9 6 9 4 5 6 a a a 8 4 3 a 
a a b a 9 0 1 5 5 6 a a a f c 2 
a a a a a a a 9 3 b a 8 0 5 5 2 
a c 6 a 8 6 a c 2 a a a a d 5 2 
8 5 5 2 c 1 4 3 a e a c 4 5 1 2 
a b b c 3 c 3 a c 5 4 5 5 3 a a 
a e a f c 3 c 4 5 5 5 5 7 a a a 
8 5 4 3 f c 5 5 5 5 5 5 1 6 a a 
a 9 3 a d 5 5 1 5 5 3 9 6 9 6 a 
a a a c 3 d 5 4 5 5 6 a d 4 5 6 
e c 4 7 c 5 5 5 5 5 5 4 5 5 5 7 
