9 5 5 5 5 5 5 5 5 5 5 5 5 5 5 3 
a 9 5 5 5 5 5 5 5 5 5 5 5 5 1 2 
a 8 3 d 1 5 5 5 5 5 5 5 5 1 6 a 
a a c 3 c 3 9 1 5 1 5 1 3 c 3 a 
a a d 0 7 a a 8 7 a d 2 a 9 2 a 
a a 9 6 9 6 a a d 0 7 a a e a a 
a a a 9 6 b a c 5 0 5 6 a d 2 a 
a a 8 6 9 0 6 9 1 4 3 9 6 9 6 a 
a a e 9 6 e b c 6 b e a 9 0 7 a 
a a 9 6 9 5 0 7 d 0 5 6 a e b a 
a a 8 7 a 9 2 9 3 c 5 3 c 5 2 a 
a a a 9 6 a c 6 c 5 5 0 7 b a a 
a a c 6 d 4 3 9 5 3 b e 9 2 a a 
8 2 9 5 5 5 6 c 3 a 8 3 a a a a 
a a c 5 5 5 5 5 6 c 6 c 6 c 6 a 
e c 5 5 5 5 5 5 5 5 5 5 5 5 5 6 
