b d 1 3 b 9 5 3 d 1 5 5 5 1 5 7 
8 7 a c 4 4 3 8 5 4 3 9 3 a 9 3 
c 5 4 1 7 9 2 a b 9 6 a c 6 c 2 
9 5 5 2 b e a c 6 8 5 6 9 1 7 e 
c 3 b a a d 2 d 1 6 b 9 2 c 5 3 
b a c 2 c 1 4 5 6 9 4 6 8 5 1 6 
a a b 8 7 a 9 7 d 6 9 1 4 1 6 b 
c 2 8 2 9 6 a 9 1 1 6 8 1 6 9 2 
b a a a 8 5 2 c 2 8 1 2 e d 2 e 
a 8 4 6 c 3 c 5 0 2 a c 1 1 2 b 
8 4 5 3 b e 9 3 a e 8 3 e a 8 2 
a b 9 2 c 3 a a c 3 a c 1 4 2 a 
a 8 6 e d 2 8 4 7 c 4 3 c 1 4 2 
a c 1 7 b a c 3 9 5 3 c 3 c 1 2 
a b a b 8 4 3 a c 1 4 3 c 5 2 a 
e c 4 4 4 5 4 4 5 4 5 4 5 7 c 6 
