9 1 5 5 1 5 5 5 1 1 1 1 1 1 1 3 
a 8 1 7 e 9 5 3 8 0 0 0 0 0 0 2 
a a c 7 9 4 3 a 8 0 0 0 0 0 0 2 
a c 7 9 4 5 6 a 8 0 0 0 0 0 0 2 
a 9 5 6 9 1 3 a 8 0 0 0 0 0 0 2 
a c 3 9 0 0 2 a 8 0 0 0 0 0 0 2 
a 9 6 8 0 0 2 a c 0 0 0 0 0 0 2 
a c 3 8 0 0 2 8 3 8 0 0 0 0 0 2 
a 9 6 8 0 0 2 c 6 8 0 0 0 0 0 2 
a c 3 8 0 0 0 1 1 0 0 0 0 0 0 2 
a 9 6 8 0 0 0 0 0 0 0 0 0 0 0 2 
c 0 7 8 0 0 0 0 0 0 0 0 0 0 0 2 
9 6 9 0 0 0 0 0 0 0 0 0 0 0 0 2 
a 9 0 0 0 0 0 0 0 0 0 0 0 0 0 2 
a 8 0 0 0 0 0 0 0 0 0 0 0 0 0 2 
e c 4 4 4 4 4 4 4 4 4 4 4 4 4 6 
