9 5 3 9 3 b 9 5 1 5 5 5 1 5 5 3 
a f a a a a a 9 2 d 3 9 4 5 3 a 
a 9 6 a 8 2 a a c 7 8 4 1 1 6 a 
a c 3 8 2 8 6 a b 9 2 b a c 1 2 
8 3 a a a a b 8 6 a c 6 c 7 e a 
e a a a 8 2 8 6 b a 9 5 5 3 9 2 
9 6 a 8 2 a a 9 4 2 c 5 3 8 2 a 
a 9 6 a a a a 8 3 c 5 3 a a a a 
a a f a 8 2 a c 6 d 3 a c 2 a a 
a c 3 8 2 a c 7 9 3 c 6 b 8 2 a 
c 3 a a a c 5 1 6 c 1 5 4 2 c 6 
b a a a c 5 1 4 5 1 4 5 1 4 5 3 
e a a 8 5 5 4 5 5 4 5 5 4 5 5 6 
9 4 2 8 5 3 9 5 5 5 3 9 5 5 5 3 
a b a c 7 8 6 9 5 3 c 6 9 5 3 a 
e c 4 5 5 4 5 4 7 c 5 5 6 d 4 6 
