d 5 5 5 5 5 5 5 5 5 5 5 5 5 5 3 
d 5 5 5 5 5 5 5 5 5 5 5 5 5 3 a 
d 5 5 5 5 5 5 5 5 5 5 5 5 1 2 a 
b d 3 9 1 1 5 5 5 5 1 5 1 2 a a 
8 3 8 2 a 8 5 3 9 3 8 5 6 a a a 
a c 6 c 6 a b a e c 6 9 1 2 a a 
8 5 3 b d 2 8 4 5 5 1 4 2 a a a 
8 5 4 6 9 0 4 1 3 b c 3 a a a a 
a b 9 3 a 8 7 8 6 a 9 2 a a a a 
c 4 6 a c 0 5 4 3 c 6 a a a a a 
9 5 5 2 d 0 7 d 2 d 5 4 4 2 a a 
a 9 3 c 7 e 9 5 2 d 5 1 5 4 2 a 
a a c 3 9 3 a 9 4 5 5 4 5 7 a a 
a c 3 c 6 c 6 c 5 5 5 5 1 3 a a 
8 1 4 1 3 9 5 5 5 5 5 5 6 c 2 a 
e c 5 6 c 4 5 5 5 5 5 5 5 5 6 e 
