9 5 5 1 5 7 9 5 1 5 3 b 9 5 1 3 
a 9 3 e 9 5 4 5 4 3 e 8 6 b e a 
8 6 e d 0 7 d 1 3 c 1 4 5 0 5 2 
a d 3 d 4 5 3 e a d 4 5 3 e b a 
8 7 a d 3 9 4 5 6 9 5 1 4 5 0 2 
a 9 4 3 a a 9 7 9 6 9 4 5 7 a a 
a c 7 a a a a d 6 9 2 9 1 5 4 2 
c 3 9 2 8 0 2 9 1 6 a a a d 3 a 
9 6 a e a a a c 6 9 6 a c 5 2 a 
a d 0 1 6 a c 7 d 4 5 4 3 9 4 2 
a d 2 e b c 5 5 7 9 1 3 c 6 d 2 
8 7 c 3 c 1 5 3 d 6 a c 7 9 7 a 
a d 1 4 5 0 5 6 9 5 2 9 3 c 5 6 
8 3 a 9 3 a b 9 2 b e a e 9 5 3 
a a c 6 c 2 a e a c 1 4 1 4 3 a 
e c 5 5 5 4 4 5 4 5 4 5 4 7 c 6 
