d 5 1 7 d 5 1 5 5 5 1 1 5 1 7 b 
d 3 a 9 5 5 2 9 5 5 6 a b a b a 
b 8 4 2 d 5 4 2 9 5 5 2 a 8 2 a 
a a 9 4 5 1 5 4 6 d 5 0 4 2 8 2 
a a 8 3 b a d 5 5 1 5 6 9 6 a a 
8 2 a c 4 2 9 5 3 c 5 5 0 3 e a 
a c 6 b 9 2 e d 4 1 5 7 a a b e 
c 7 9 0 6 e b 9 3 a d 5 2 8 2 b 
9 5 6 c 5 1 6 c 4 0 5 3 c 2 8 2 
a 9 1 3 d 6 9 3 d 4 5 0 1 2 a a 
a 8 0 2 9 5 2 8 5 3 d 6 e a a a 
a 8 0 2 8 7 e a 9 4 5 3 b e a a 
a c 0 2 c 5 3 a c 5 5 4 2 b a a 
8 3 c 6 9 5 6 8 7 d 5 3 8 4 2 a 
a 8 7 9 6 d 3 a 9 5 5 4 6 d 4 6 
e c 5 4 5 5 4 4 4 5 5 5 5 5 5 7 
