9 5 1 5 1 1 5 1 5 5 1 5 1 5 1 7 
8 7 a b a a b 8 3 9 6 9 4 1 4 3 
a d 2 e a 8 2 a 8 4 7 c 1 4 1 6 
8 5 0 5 4 2 c 0 6 9 5 1 4 1 4 3 
a 9 0 3 9 4 1 6 9 4 1 4 1 4 1 6 
c 2 a 8 4 1 6 9 4 1 4 1 4 1 4 3 
b c 0 4 1 4 3 c 5 4 1 4 1 4 1 6 
a d 4 1 4 1 6 9 3 b c 1 4 1 4 3 
a b 9 4 1 4 3 c 4 2 9 4 1 4 1 6 
c 2 c 1 4 1 6 9 5 2 c 1 4 1 4 3 
9 2 b c 1 4 1 6 9 6 9 4 1 4 1 6 
a c 2 b c 1 4 1 4 7 c 1 4 1 4 3 
8 7 8 2 d 4 5 4 7 d 5 4 5 4 1 6 
8 7 a 8 3 9 3 b b b b b b b c 3 
8 3 c 2 8 2 8 0 0 0 0 0 0 0 1 2 
e e d 6 e c 6 e e e e e e e e e 
