9 5 5 5 5 5 5 5 5 5 5 5 5 5 5 3 
a 9 5 5 7 9 5 5 5 5 5 5 5 5 5 2 
a a 9 5 3 c 3 9 3 9 3 9 5 5 3 a 
a a a b c 3 c 6 c 6 a c 3 9 6 a 
a a c 0 7 a 9 3 9 3 a 9 6 c 3 a 
a a 9 6 9 6 a c 6 c 6 a b 9 6 a 
a a a 9 6 b 8 5 5 5 5 6 8 0 7 a 
a a a a 9 2 e 9 3 9 5 5 6 e 9 2 
a a a 8 6 c 3 c 2 c 5 3 9 1 6 a 
a a a e 9 5 6 d 4 1 7 a a e b a 
a a a 9 6 b 9 5 3 c 3 a c 5 2 a 
a a a c 5 2 8 7 a 9 2 c 5 3 a a 
a a a 9 5 6 c 3 8 6 e 9 3 a a a 
8 2 a c 5 5 5 6 c 5 5 6 c 6 a a 
a a c 5 5 5 5 5 5 5 5 5 5 5 6 a 
e c 5 5 5 5 5 5 5 5 5 5 5 5 5 6 
