9 5 5 5 5 5 5 1 5 5 5 5 5 5 5 3 
a 9 3 9 3 9 3 c 5 5 5 5 5 5 3 a 
a a c 6 c 6 c 3 9 5 5 5 5 5 6 a 
a a 9 3 9 3 9 6 c 5 5 5 5 5 3 a 
a c 6 c 6 a c 3 9 5 5 5 5 5 6 a 
a 9 3 9 3 a 9 6 c 5 5 5 5 5 3 a 
8 6 c 6 c 6 c 7 9 5 5 5 5 5 6 a 
8 5 3 9 5 5 3 9 2 b 9 3 9 3 d 2 
8 3 c 6 9 5 6 c 2 c 6 c 6 c 1 2 
a c 5 3 c 1 7 b a d 3 d 1 3 a a 
a 9 3 c 3 c 5 6 a d 0 3 e c 6 a 
a a c 3 c 1 7 b a d 6 c 5 3 b a 
a 8 3 c 5 6 9 6 a d 1 3 9 6 c 2 
a e c 5 5 5 4 7 a d 6 a c 5 3 a 
8 5 5 5 5 5 5 5 6 9 7 c 5 3 c 2 
e d 5 5 5 5 5 5 5 4 5 5 5 4 5 6 
