9 5 5 5 5 5 5 5 5 5 5 5 5 1 5 3 
a d 1 5 5 5 5 5 1 3 9 1 5 4 1 2 
a 9 4 1 5 3 d 5 2 8 2 c 3 9 6 a 
a 8 1 4 1 4 3 9 6 a c 3 8 2 b a 
a e c 3 c 3 c 0 3 a d 2 a c 2 a 
8 7 9 2 9 4 7 e a 8 7 a c 1 6 a 
8 7 e 8 2 b 9 7 c 2 9 6 9 4 3 a 
c 3 9 6 8 0 2 9 3 8 6 9 6 9 6 a 
d 2 c 5 6 e a c 2 e 9 2 9 0 7 a 
9 6 9 3 9 3 c 5 6 9 6 8 6 e b a 
8 7 a a a a 9 3 9 0 3 c 3 d 2 a 
c 3 a c 6 c 2 c 6 e c 3 c 3 8 2 
d 2 a d 1 5 0 1 7 b b c 3 8 2 a 
9 6 8 5 0 5 2 c 1 4 0 7 a a 8 2 
8 1 4 1 4 1 4 1 4 1 4 1 4 0 6 a 
e c 5 4 7 c 5 4 7 c 5 4 7 c 5 6 
