9 5 5 1 5 1 1 5 5 7 9 1 5 5 1 3 
a b b c 7 e 8 3 9 3 a e b 9 6 a 
c 2 a 9 5 3 a 8 2 c 0 5 0 6 d 2 
b 8 0 4 7 a a a a 9 6 9 2 d 5 2 
a a c 3 d 2 c 4 4 6 9 2 a 9 5 2 
a a b c 1 6 9 5 5 5 2 8 6 a d 2 
a c 2 9 6 9 4 5 5 5 0 6 9 6 d 2 
a b c 2 b 8 3 9 3 9 6 d 2 9 5 2 
c 0 5 4 2 a a 8 6 c 3 9 6 8 1 6 
b c 3 9 2 a a 8 3 9 6 c 3 a a f 
a b 8 2 a c 4 6 c 6 b 9 6 c 4 3 
a 8 6 a a d 3 b 9 7 a a d 1 5 2 
8 6 9 2 8 3 a a a b 8 6 9 6 d 2 
a 9 2 c 2 a 8 6 8 6 a b c 3 b a 
8 2 c 1 4 6 a 9 6 9 4 2 9 6 8 6 
e c 5 4 5 5 4 4 5 4 5 4 4 5 4 7 
