9 5 1 5 1 5 1 5 1 1 5 5 5 5 5 3 
a 9 6 b 8 7 c 7 a e b d 1 5 5 2 
a c 5 2 8 5 5 5 0 5 4 7 a d 3 a 
8 7 b e e 9 5 3 a d 1 5 0 5 2 a 
8 5 6 d 5 2 b 8 4 7 8 7 a b a a 
a d 1 5 3 e a e d 1 6 b e a a a 
8 7 a b c 5 4 5 7 a 9 0 5 6 a a 
a b c 4 5 3 b 9 1 4 6 a 9 5 6 a 
a c 5 5 3 a a c 6 d 1 2 a 9 5 2 
8 5 5 7 a a 8 5 5 7 a a a a b a 
a b d 1 6 e a d 5 5 6 a 8 6 a a 
a 8 3 a d 5 2 9 5 1 5 2 e 9 4 2 
a e a 8 5 3 a e b a d 0 5 6 b a 
8 5 2 8 1 6 8 5 2 8 7 a b d 2 a 
8 5 4 6 a d 6 b e a d 6 8 7 a e 
e d 5 5 4 5 5 4 5 4 5 5 4 5 4 7 
