b 9 1 1 5 1 5 1 1 7 d 1 5 1 5 3 
a a e a b a b a c 5 5 6 9 2 f a 
8 2 b a a a a a 9 5 5 1 6 c 1 2 
e c 2 e a e a e c 3 d 4 3 9 6 a 
9 5 4 5 4 1 6 d 1 4 5 3 8 2 9 2 
a 9 3 9 3 8 5 7 c 3 f a e a a e 
c 6 c 6 a e 9 5 5 0 3 8 3 a a b 
9 5 1 5 2 b a 9 3 a c 2 c 6 c 2 
a 9 6 9 6 a a 8 6 a b e d 5 5 2 
8 6 9 6 d 2 c 4 5 6 a 9 5 5 7 a 
a 9 6 9 5 4 3 d 5 5 2 a d 5 5 2 
c 4 5 4 3 9 6 9 1 5 2 8 5 5 7 a 
9 5 5 5 0 6 9 6 a 9 6 a d 5 5 2 
a 9 5 3 a 9 6 9 2 c 3 8 1 7 d 2 
a a d 6 8 6 9 6 a 9 6 a c 1 5 6 
e c 5 5 4 5 4 5 6 c 5 6 d 4 5 7 
