9 1 5 5 7 9 5 5 5 5 1 5 5 5 1 3 
a 8 5 3 b a 9 5 5 3 a 9 5 5 2 a 
8 6 b c 2 a 8 5 3 a e 8 7 b c 2 
a 9 0 3 a a 8 5 2 a 9 2 9 0 1 2 
a a a a 8 6 c 5 0 6 a a a a a a 
8 2 a a e 9 1 5 4 1 6 e a a a a 
a a a c 3 e c 5 3 e f 9 6 a a a 
a a 8 5 4 3 b 9 2 9 1 4 7 8 6 a 
8 0 2 9 5 2 a c 6 a 8 5 3 8 3 a 
a a a a 9 2 8 5 5 6 8 3 a a a a 
a a a a a a a 9 5 5 2 a a a 8 2 
a a a a a 8 2 a 9 5 2 a a a a a 
8 2 c 4 6 a 8 6 8 5 2 c 4 6 a a 
a 8 5 5 5 6 a 9 4 5 4 5 5 5 6 a 
a a 9 5 5 5 6 a d 5 5 1 5 5 3 a 
e c 4 5 5 5 5 4 5 5 5 4 5 7 c 6 
