9 5 5 5 5 5 5 1 1 5 5 5 5 5 5 3 
a 9 5 1 5 1 5 6 c 3 b b 9 7 b a 
a a d 6 9 6 9 5 5 4 2 a 8 5 2 a 
a c 5 3 c 7 c 5 1 3 a 8 6 b a a 
a 9 3 c 1 7 9 1 6 c 0 4 5 6 e a 
a a c 3 c 3 a c 1 7 8 3 9 5 3 a 
a 8 7 c 3 a 8 7 e d 6 e c 3 a a 
8 0 5 7 a e e 9 3 d 5 5 5 6 c 2 
a c 1 7 c 1 7 c 4 3 b b b b 9 2 
a 9 6 b b c 5 7 b a 8 0 0 0 2 a 
a 8 5 6 c 1 5 5 6 a e e e e e a 
a 8 3 9 7 a 9 1 5 6 d 5 3 d 1 2 
a a e 8 5 6 a a b 9 1 5 6 d 2 a 
a c 5 6 9 5 6 a c 6 c 5 3 d 2 a 
8 3 d 5 2 b d 2 9 5 5 5 6 d 6 a 
e c 5 5 6 c 5 4 4 5 5 5 5 5 5 6 
