b 9 3 9 5 5 1 5 5 5 7 9 5 5 1 3 
a a a c 5 3 8 3 9 5 1 4 5 3 e a 
8 2 8 1 5 6 a a a f 8 5 5 0 5 2 
a a a c 5 3 a a 8 5 4 1 5 2 9 2 
a 8 0 5 5 6 c 0 2 9 5 4 3 8 6 a 
8 2 a d 5 5 5 2 c 6 d 5 0 4 3 a 
a a 8 5 5 5 1 4 5 5 5 7 c 7 8 6 
a a c 5 5 5 6 9 1 1 5 5 5 5 4 3 
8 2 9 5 5 5 3 c 6 c 5 5 5 5 1 6 
a a 8 5 5 5 4 1 5 5 5 7 9 7 8 3 
a a a d 5 5 5 2 9 3 d 5 0 1 6 a 
8 2 8 5 5 3 9 0 2 c 5 1 6 8 3 a 
a a a 9 5 6 a a 8 5 1 4 5 2 c 2 
a 8 0 4 5 3 a a a f 8 5 5 0 5 2 
a a a 9 5 6 8 6 c 5 4 1 5 6 b a 
e e e c 5 5 4 5 5 5 7 c 5 5 4 6 
