9 5 1 1 1 1 5 1 1 5 1 1 1 1 5 3 
8 7 a a a e 9 2 c 3 a e e c 3 a 
a 9 4 2 8 1 2 8 3 8 2 9 5 1 0 6 
c 4 1 0 6 a c 2 c 2 e 8 3 a 8 7 
9 5 2 c 1 4 3 c 5 6 9 6 a 8 0 7 
8 7 c 3 8 7 a d 3 9 4 5 2 a 8 7 
8 5 1 4 4 3 8 7 c 0 5 1 6 8 0 7 
8 5 2 9 3 8 2 9 3 a b e 9 6 8 3 
8 5 4 2 a e a c 4 6 8 5 4 7 a a 
8 5 5 4 0 1 2 9 5 7 a b 9 5 4 2 
c 1 5 3 e a c 4 3 b c 0 4 3 b a 
9 4 7 8 5 0 5 1 4 4 7 e 9 4 0 6 
c 3 9 6 b a d 0 5 7 9 3 e 9 2 b 
9 4 0 5 2 a d 0 7 d 2 a 9 2 c 2 
a b 8 5 2 a d 0 5 7 a 8 6 8 5 2 
e e c 7 c 6 d 4 5 5 6 c 5 4 5 6 
