9 5 5 5 5 1 5 7 d 5 1 5 5 5 5 3 
a d 5 5 3 8 5 5 5 5 2 d 5 5 5 2 
8 5 5 1 2 8 5 5 5 7 8 5 5 5 5 2 
c 5 3 a a 8 5 5 5 1 2 d 5 1 5 6 
9 5 6 a 8 2 d 5 5 2 8 1 3 c 5 3 
a 9 7 a a c 1 1 5 6 a a 8 5 5 2 
a a 9 4 4 5 2 c 5 5 2 a 8 5 1 2 
a a 8 5 5 3 a 9 3 9 4 4 2 b a a 
a c 6 d 1 0 6 8 6 c 1 3 8 2 a a 
8 5 5 3 a a b a 9 5 2 8 2 e 8 2 
a d 3 a a a a c 4 5 6 e c 5 6 a 
c 5 6 a c 6 a b 9 3 9 5 5 1 7 a 
9 5 5 4 3 9 2 a a a a 9 3 a 9 2 
a 9 5 5 4 2 c 0 6 a a a a a a a 
a a d 5 1 4 3 c 5 4 6 a a a c 2 
e c 5 7 c 5 4 5 5 5 5 6 c 4 5 6 
