9 1 5 5 5 5 5 5 5 5 5 5 5 5 5 3 
a a d 1 5 1 1 5 5 3 9 5 5 5 3 a 
c 4 5 2 d 6 e 9 1 2 a b b b a a 
b b b a d 5 1 6 e e a a 8 6 a a 
a e 8 6 d 5 4 1 5 5 2 c 4 3 a a 
8 5 4 5 5 5 3 c 3 b c 1 5 6 a a 
a 9 5 5 1 3 8 7 a c 1 6 9 5 2 a 
8 6 9 5 6 a a 9 2 b a 9 4 3 a a 
e 9 4 1 7 8 2 c 6 a 8 6 d 4 0 2 
9 6 9 4 5 6 c 5 1 2 c 5 5 5 6 a 
8 1 4 5 5 5 1 1 6 8 7 b 9 7 b a 
a a 9 5 1 3 a 8 5 4 5 4 2 9 2 a 
a c 4 1 2 a a 8 5 1 1 7 8 2 a a 
8 1 5 2 e a e c 5 2 8 5 6 a a a 
a a 9 4 7 c 5 5 5 6 c 5 1 6 e e 
e c 4 5 5 5 7 d 5 5 5 5 4 5 5 7 
