9 1 3 9 1 7 f 9 1 7 b d 3 d 1 3 
a a a a 8 5 7 a 8 7 c 3 c 5 2 a 
a a a a 8 5 7 a 8 7 b c 5 5 2 a 
a e c 6 c 5 5 6 8 5 6 d 1 5 2 a 
a b b 9 7 9 3 b 8 5 5 3 c 5 2 a 
a a a a 9 6 c 2 8 5 5 4 1 5 2 a 
a a 8 2 8 1 1 6 c 5 5 5 4 5 6 a 
a a a 8 2 a a 9 1 5 5 5 5 5 5 6 
c 4 4 6 c 4 2 c 6 9 5 5 5 5 5 3 
9 5 1 7 d 3 c 5 5 6 9 1 3 9 3 a 
8 5 2 9 5 4 5 3 9 5 6 a e e c 2 
8 5 2 c 5 1 5 2 8 5 5 4 5 3 d 2 
8 5 2 9 5 4 5 2 8 5 3 b 9 4 5 2 
8 5 2 8 7 9 5 2 c 5 0 0 4 5 5 2 
8 7 a c 1 6 9 6 b b a 8 3 b b a 
e d 4 5 6 d 4 5 4 4 4 6 c 4 4 6 
