b b b 9 5 5 5 5 5 5 5 5 5 5 5 3 
a a 8 2 9 5 5 5 5 5 5 5 5 5 5 2 
c 0 2 a a d 5 5 3 9 5 5 5 5 3 a 
9 6 a a a 9 5 5 0 6 9 5 5 5 2 a 
8 5 6 a a 8 5 1 4 3 c 5 5 3 a a 
8 5 5 6 a a 9 4 7 e 9 5 5 6 a a 
a 9 5 5 6 8 0 7 9 3 c 5 5 3 a a 
a 8 5 5 5 6 e 9 2 8 5 5 5 6 e e 
a a 9 5 5 3 b c 6 8 1 5 1 5 5 3 
e e 8 5 3 a 8 5 5 6 c 1 0 7 b a 
9 5 4 3 a a c 5 5 5 5 6 c 7 a a 
8 5 3 a a a 9 5 5 5 5 5 5 5 4 2 
c 3 a a a a c 5 5 5 5 5 5 5 3 a 
9 0 2 a a c 5 5 5 5 5 5 5 5 6 e 
a a 8 2 c 5 5 5 5 5 5 5 5 5 5 3 
e e e c 5 5 5 5 5 5 5 5 5 5 5 6 
