9 3 9 5 5 1 7 9 3 9 3 9 5 5 5 3 
a c 6 9 3 a 9 6 c 2 a a 9 5 5 6 
a 9 5 6 c 6 c 3 9 2 a a a d 1 3 
a a 9 5 5 5 5 6 e 8 4 6 a b a a 
a a 8 3 9 3 9 3 9 2 9 3 8 2 a a 
a 8 6 c 6 c 6 8 6 c 6 c 6 c 6 a 
a a 9 3 9 5 3 c 7 b b b b 9 5 2 
a a a a a 9 6 9 1 0 0 0 0 0 7 a 
a a a a a 8 3 c 6 e e e e c 1 6 
a a a a a e c 5 5 5 5 5 5 5 4 3 
a a a c 6 9 3 9 3 9 3 9 3 9 3 a 
a a c 5 1 6 c 6 c 6 c 6 c 6 c 6 
a 8 5 1 6 b 9 5 5 5 5 5 5 3 d 3 
a c 3 c 5 4 6 9 5 1 5 1 5 6 9 2 
8 3 c 5 5 5 5 6 b c 5 4 5 5 6 a 
e c 5 5 5 5 5 5 4 5 5 5 5 5 5 6 
