b 9 5 5 5 3 9 5 1 5 7 d 5 1 1 3 
a 8 5 5 5 2 8 7 c 5 3 9 1 2 a a 
8 0 5 1 3 a a d 5 1 4 2 a a a a 
a a 9 6 a a a d 3 c 3 a a c 2 a 
a a a b a 8 0 3 c 1 6 e c 5 2 a 
a 8 6 a a a a 8 7 a 9 1 1 1 4 6 
a a d 4 4 4 6 c 5 6 a e e 8 5 3 
8 0 5 5 5 5 3 9 1 3 8 5 7 8 5 2 
a a 9 1 1 5 6 c 6 a a 9 1 6 9 2 
a a a a a 9 3 9 3 c 2 a a b a a 
a e a a a a a a e 9 4 6 e a a a 
a 9 4 4 6 a a a b 8 5 5 5 2 a a 
8 2 9 1 1 2 a a 8 6 b d 5 0 2 a 
a a a a e a a c 6 d 6 9 3 a a a 
a a a 8 5 4 4 3 d 5 5 6 8 2 a a 
e c 6 e d 5 5 4 5 5 5 5 6 e c 6 
