9 5 1 5 3 d 1 5 5 3 d 1 5 3 9 3 
a b a b a b a 9 3 a f a b 8 2 a 
a a e a a e a a a c 5 6 a a 8 6 
a 8 5 2 c 5 2 8 4 5 1 1 4 4 4 3 
a c 5 0 5 3 a c 5 5 6 a 9 5 3 a 
8 5 3 a b a c 5 7 9 5 4 4 5 6 a 
a b a e a a 9 5 3 8 3 9 5 1 5 6 
a a 8 5 2 a a 9 2 a a a f a b b 
a a a f a 8 6 c 6 a a c 5 2 a a 
e e a 9 6 a 9 5 3 c 0 5 3 a e a 
9 5 2 a 9 6 c 3 c 3 e 9 2 c 5 2 
a b a a c 5 5 4 3 c 5 6 8 5 3 a 
a a a c 5 1 5 3 c 5 3 9 0 5 6 a 
a a 8 5 3 a f 8 5 3 a a a 9 5 2 
a e a f a c 7 a f a c 4 6 a f a 
e d 4 5 4 5 5 6 d 4 5 5 5 4 5 6 
