b 9 5 5 1 5 5 7 9 5 1 5 5 5 1 3 
a 8 5 1 4 1 5 5 0 5 0 5 5 5 6 a 
a a 9 6 9 4 5 7 c 1 4 5 5 5 3 a 
a 8 6 9 4 5 1 5 7 8 5 5 5 5 2 e 
a 8 1 4 5 1 6 d 1 4 5 3 d 5 4 3 
a a 8 5 5 0 5 3 c 5 5 6 9 5 1 2 
a 8 0 5 5 4 5 4 5 7 9 5 4 5 6 a 
8 6 c 5 5 5 7 9 1 1 4 7 b d 5 6 
8 3 9 5 5 5 7 c 6 c 1 7 e d 5 3 
a 8 0 5 5 1 5 1 5 7 c 5 1 5 3 a 
a a 8 5 5 0 5 6 9 5 5 3 c 5 4 2 
a 8 4 1 5 4 3 d 4 1 5 6 d 5 1 6 
a 8 3 c 1 5 4 5 7 8 5 5 5 5 2 b 
a a c 3 c 1 5 7 9 4 1 5 5 5 6 a 
a 8 5 4 1 4 5 5 0 5 0 5 5 5 3 a 
e c 5 5 4 5 5 7 c 5 4 5 5 5 4 6 
