d 5 5 5 5 3 d 1 5 5 5 5 1 5 1 3 
9 3 9 1 3 a d 0 5 1 7 d 0 7 a a 
a c 2 a c 4 5 4 3 c 3 d 4 3 a a 
a 9 6 c 1 5 5 3 c 1 4 5 5 6 a a 
c 4 5 5 0 3 9 6 d 4 1 7 9 7 c 2 
9 5 5 5 6 8 2 9 1 5 4 1 0 7 b a 
a 9 5 1 5 6 e e c 5 7 a c 1 4 2 
a c 5 0 7 d 3 9 3 d 7 8 1 6 f e 
c 5 1 4 5 5 6 c 4 3 9 6 c 5 5 3 
9 3 8 5 7 9 7 9 5 2 8 5 5 1 3 a 
a 8 0 5 7 c 1 4 5 2 c 1 1 2 c 2 
a 8 6 9 5 3 a 9 5 2 9 6 a 8 5 6 
a a d 0 3 8 6 c 1 0 2 9 4 2 d 3 
a a 9 6 a 8 1 3 e 8 6 c 1 4 3 a 
a a c 5 6 a e a 9 4 1 5 4 7 c 6 
e e d 5 5 4 5 4 4 7 c 5 5 5 5 7 
