b 9 5 5 5 7 9 5 5 5 5 5 7 9 5 3 
a a d 5 5 5 2 d 5 5 5 5 5 2 b a 
a 8 5 5 5 5 4 1 5 5 5 5 7 a a a 
a a 9 5 5 5 5 4 5 5 3 d 5 2 e a 
a a a 9 1 5 5 5 7 b 8 5 3 8 5 2 
8 2 c 2 c 1 5 5 5 2 a f 8 2 b a 
a a b a b a 9 5 7 8 0 5 2 a e a 
8 2 e a a a 8 1 3 a a b e c 5 6 
a 8 5 2 a a a c 6 a a a b 9 5 3 
a a b a a a 8 5 5 0 0 2 a a b a 
a a a e a e 8 5 5 6 a 8 2 a e a 
8 2 e d 4 5 4 5 5 5 6 a c 0 5 2 
a a 9 5 5 1 5 5 5 7 9 4 7 a b a 
a 8 4 5 7 a d 5 5 5 2 d 5 2 a a 
a a d 5 5 4 5 5 5 5 0 5 7 a e a 
e c 5 5 5 5 5 5 5 7 e d 5 4 5 6 
