9 5 5 5 5 5 5 5 5 5 5 5 5 5 5 3 
a 9 5 5 5 5 5 5 5 5 5 5 5 5 5 2 
a a 9 5 1 7 9 3 9 3 9 5 5 5 3 a 
a a a b c 5 6 a a a a d 3 9 6 a 
a a a 8 5 5 5 2 a a a d 0 6 9 2 
a a a a 9 3 b e a c 6 9 6 b a a 
a a a c 6 a 8 5 6 d 1 4 7 8 2 a 
a a a 9 1 6 a 9 3 9 4 7 b a a a 
a a a a e 9 2 c 4 4 5 3 8 2 a a 
a a a a 9 6 e d 5 1 3 a a e e a 
a a a a 8 3 9 5 1 6 a a c 5 3 a 
a a a c 6 a c 1 4 3 a c 5 3 a a 
a c 2 9 5 6 9 4 1 6 a 9 3 a a a 
8 3 a c 5 5 4 5 4 7 c 6 c 6 a a 
a a c 5 5 5 5 5 5 5 5 5 5 5 6 a 
e c 5 5 5 5 5 5 5 5 5 5 5 5 5 6 
