9 1 5 5 5 1 5 5 5 3 9 1 5 1 7 f 
a e 9 7 d 6 9 5 5 4 6 e 9 6 f b 
a b 8 5 5 5 4 1 7 d 3 9 6 f 9 6 
8 2 c 5 5 5 3 e 9 3 8 6 f 9 0 3 
a a d 1 5 5 6 d 2 8 6 f 9 6 a a 
a a b a 9 5 1 7 a e f 9 4 1 6 a 
a a a c 6 b 8 5 6 f 9 4 1 6 f a 
8 6 8 1 3 a a 9 3 9 4 5 6 9 5 6 
a b a a 8 2 a c 4 2 d 1 5 4 1 7 
a c 6 a a a 8 5 5 6 9 4 5 1 4 7 
a d 5 0 6 a e 9 3 9 4 5 1 4 5 3 
c 5 5 4 5 0 7 a a c 1 5 4 5 5 6 
9 5 5 5 3 8 3 a c 3 a 9 5 5 5 3 
a 9 5 3 a a a 8 7 a c 2 9 1 3 a 
a a f c 6 a a a d 4 1 4 6 a c 6 
e c 5 5 5 6 c 6 d 7 c 5 5 4 5 7 
