9 5 1 5 5 7 9 5 1 5 1 5 5 5 5 3 
a f c 5 1 5 6 f a f a d 5 5 7 a 
8 5 5 1 6 9 5 5 4 5 4 5 5 1 5 2 
a 9 3 a b 8 5 7 b d 1 5 5 2 b a 
a a a a a a 9 1 0 3 a b f a e a 
a a a e 8 2 8 0 0 2 a 8 5 4 5 2 
a a c 3 a a c 4 4 6 a a d 5 3 a 
8 4 3 a a c 5 1 3 d 6 8 5 3 a a 
e f a a 8 5 3 c 4 5 5 6 b a a a 
9 5 2 a a f c 5 5 5 5 5 2 a a a 
a f e a c 5 5 5 5 5 5 5 2 8 4 2 
8 5 3 8 5 1 5 5 5 5 5 3 a 8 3 a 
a b a a f c 5 5 5 5 5 2 a a a a 
a a a 8 1 5 1 5 1 3 f a c 6 a a 
a e a e a f a f a c 5 4 5 5 6 a 
e d 4 5 4 7 c 5 4 5 5 5 5 5 5 6 
