b b d 5 5 5 5 5 5 5 5 5 5 5 5 3 
e a 9 5 5 5 5 1 5 5 5 5 5 5 3 e 
9 4 4 5 5 5 5 4 5 5 5 5 1 5 4 7 
a 9 7 9 5 5 5 5 3 d 5 7 a b b b 
a e 9 4 5 5 5 7 c 3 f 9 6 8 4 2 
8 5 6 d 5 5 5 5 3 c 1 6 9 6 9 2 
a b 9 5 1 5 1 5 4 7 a d 4 1 6 a 
a a a b a f a 9 3 b a 9 5 4 5 2 
a c 4 4 2 9 2 c 2 a a a d 5 5 2 
8 5 5 3 c 2 c 3 a e a c 5 5 1 2 
a b b c 3 c 3 a c 5 0 5 5 3 a a 
a e a f c 3 c 4 5 7 c 5 7 a a a 
8 5 4 3 d 4 5 5 5 5 5 5 1 6 a a 
a 9 3 a d 5 5 1 5 5 3 9 6 9 6 a 
a a a c 3 d 5 4 5 5 6 a d 4 5 6 
e c 4 7 c 5 5 5 5 5 5 4 5 5 5 7 
