9 1 5 1 5 5 5 3 9 5 5 3 9 1 5 3 
a a b a d 5 5 2 8 1 3 8 2 a d 2 
a a a 8 5 5 5 2 a a a a a c 5 6 
a e a a d 5 5 2 c 6 a a c 5 5 3 
8 5 4 4 5 5 7 c 5 5 6 c 5 5 5 2 
a d 5 5 3 9 5 1 5 5 3 9 5 5 3 a 
8 1 5 3 a a 9 0 5 3 a a 9 7 a a 
a a b a a a a 8 3 a a a c 5 6 a 
a e a e a a a c 6 a a c 5 5 5 2 
c 5 4 1 6 c 4 5 5 4 4 5 3 9 3 a 
9 5 5 0 5 7 d 5 1 5 5 1 6 a a a 
a 9 5 0 1 5 1 3 a d 5 4 5 4 0 2 
a a b a a b a a 8 5 5 5 5 7 a a 
a a a a a a a a 8 5 5 5 5 5 2 a 
a a a e a a e a a d 5 5 5 5 6 a 
e c 4 5 4 4 5 6 c 5 5 5 5 5 5 6 
