9 5 3 d 1 3 9 3 9 3 9 3 9 3 9 3 
a d 0 7 a 8 2 a a a a c 2 c 6 a 
a d 0 7 a e e c 6 a c 3 e 9 5 2 
a d 2 9 4 5 5 3 9 6 9 6 9 6 9 6 
a d 0 6 9 5 3 a a 9 6 9 6 b c 3 
a 9 4 3 c 3 c 6 c 6 9 6 9 4 3 a 
a c 1 6 9 6 d 3 9 5 6 b c 3 c 2 
a 9 4 3 c 3 d 0 0 7 b 8 3 8 5 2 
a c 1 6 9 6 d 0 0 7 c 2 c 6 b a 
a 9 4 3 a 9 3 e e d 3 c 3 b 8 6 
a c 1 6 c 6 8 3 9 7 c 3 8 0 4 3 
a 9 4 3 b 9 6 a a 9 3 c 6 c 1 6 
a c 1 2 8 6 9 6 c 6 a b b 9 0 3 
a 9 2 8 6 9 6 b b b a 8 0 2 a a 
8 2 8 4 3 c 3 8 0 2 8 2 e c 6 a 
e c 4 7 c 7 c 6 e c 6 c 5 5 5 6 
