9 5 3 9 3 9 5 3 9 3 9 5 5 3 9 3 
c 3 8 6 c 2 9 0 6 8 0 7 d 0 6 a 
9 6 e 9 1 2 e 8 3 e 8 3 9 6 9 6 
c 1 3 a e c 7 e e d 6 a c 3 a b 
9 6 e c 5 7 d 5 5 3 d 2 d 2 c 2 
e 9 5 5 5 5 5 3 d 2 9 4 3 e b a 
b c 5 1 5 5 3 a d 2 e d 6 d 0 6 
c 5 7 8 7 d 2 8 3 c 1 3 d 3 c 3 
9 5 5 4 5 5 6 c 2 d 6 c 3 c 5 2 
a d 7 f b b 9 3 a d 3 d 2 d 1 6 
a d 5 5 6 e a a a d 0 5 2 d 4 3 
a 9 1 5 3 b a a a d 6 d 4 3 b a 
a a e d 0 2 a a a d 1 3 b a 8 6 
a c 5 3 e c 6 c 6 d 6 8 6 c 2 b 
8 3 b a b b b b b 9 3 a 9 3 c 2 
e c 4 4 4 4 4 4 4 6 c 4 6 c 5 6 
