9 1 1 1 1 1 1 1 1 1 1 1 1 1 1 3 
8 0 0 0 0 0 0 0 0 0 0 0 0 0 0 2 
8 0 0 0 0 0 0 0 0 0 0 0 0 0 0 2 
8 0 0 0 0 0 0 0 0 0 0 0 0 0 0 2 
8 0 0 0 0 0 0 0 0 0 0 0 0 0 0 2 
8 0 0 0 0 0 0 0 0 0 0 0 0 0 0 2 
8 0 0 0 0 0 0 0 0 0 0 0 0 0 0 2 
8 0 0 0 0 0 0 0 0 0 0 0 0 0 0 2 
8 0 0 0 0 0 0 0 0 0 0 0 0 0 0 2 
8 0 0 0 0 0 0 0 0 0 0 0 0 0 0 2 
c 4 4 4 4 4 4 4 4 4 0 0 0 0 0 2 
9 3 9 5 5 5 5 5 5 3 8 0 0 0 0 2 
a 8 6 9 5 5 1 5 5 6 8 0 0 0 0 2 
a e b a 9 3 c 5 1 3 8 0 0 0 0 2 
a b a c 6 8 3 b a a 8 0 0 0 0 2 
e c 4 5 5 6 c 4 4 6 c 4 4 4 4 6 
