9 5 5 3 d 7 9 3 9 3 d 7 9 5 5 3 
a 9 5 4 5 1 6 a a c 1 5 4 5 1 2 
a c 5 5 3 e 9 2 8 3 e 9 5 5 6 a 
8 5 5 1 2 9 2 a a 8 3 8 1 5 5 2 
a b f e a a a a a a a a e f b a 
a c 5 3 a c 2 c 6 8 6 a 9 5 6 a 
8 3 b a c 3 c 5 1 6 9 6 a b 9 2 
a a e c 3 a f 9 2 f a 9 6 e a a 
a c 3 b a c 7 c 6 d 6 a b 9 6 a 
a f a e 8 5 7 b b d 5 2 e a f a 
c 1 4 1 4 7 9 6 c 3 d 4 1 4 1 6 
f a f a 9 1 6 b b c 1 3 a f a f 
d 4 5 2 e e 9 2 8 3 e e 8 5 4 7 
9 5 3 8 5 5 6 a a a d 5 2 9 5 3 
a b a c 5 5 5 4 2 c 5 5 6 a f a 
e e c 5 5 5 5 5 4 5 5 5 5 4 5 6 
