9 1 1 1 1 1 1 1 1 1 1 1 1 1 1 3 
8 0 0 0 0 0 0 0 0 0 0 0 0 0 0 2 
8 0 0 0 0 0 0 0 0 0 0 0 0 0 0 2 
8 0 0 0 0 0 0 0 0 0 0 0 0 0 0 2 
8 0 0 0 0 0 0 0 0 0 0 0 0 0 0 2 
8 0 0 0 0 0 0 0 0 0 0 0 0 0 0 2 
8 0 0 0 0 0 0 0 0 0 0 0 0 0 0 2 
8 0 0 0 0 0 0 0 0 0 0 0 0 0 0 2 
8 0 0 0 0 0 0 0 0 0 0 0 0 0 0 2 
8 0 0 0 0 0 0 0 0 0 0 0 0 0 0 2 
c 4 4 4 4 0 0 0 0 0 0 0 0 0 0 2 
9 3 9 3 b 8 0 0 0 0 0 0 0 0 0 2 
a 8 2 a a 8 0 0 0 0 0 0 0 0 0 2 
e a 8 6 a 8 0 0 0 0 0 0 0 0 0 2 
9 2 c 3 a 8 0 0 0 0 0 0 0 0 0 2 
e c 7 c 6 c 4 4 4 4 4 4 4 4 4 6 
