9 5 5 5 5 5 5 5 5 5 5 5 5 5 1 7 
a 9 5 3 9 5 3 d 1 3 d 1 5 5 0 3 
a c 3 a a d 0 3 a c 3 c 1 7 e e 
a 9 6 a c 3 e a a d 0 5 6 d 3 b 
a a d 4 5 6 9 6 c 3 e 9 3 9 0 2 
a c 5 3 9 3 c 5 5 4 7 a c 6 e a 
a b b c 6 a 9 5 5 3 9 6 9 5 3 a 
a 8 0 7 b a a 9 3 a a 9 6 9 6 a 
a a a 9 4 6 a 8 6 a a a 9 0 7 a 
a a c 6 9 3 8 4 7 a c 6 a e b a 
a a 9 3 a c 6 9 3 c 5 3 c 5 2 a 
a a a 8 0 7 9 6 c 5 5 0 7 b a a 
a c 6 e e d 2 9 5 3 b e b a a a 
8 3 9 5 5 5 6 c 3 c 0 3 8 0 2 a 
a a c 5 5 5 5 5 4 7 e c 6 e e a 
e c 5 5 5 5 5 5 5 5 5 5 5 5 5 6 
