9 5 5 5 1 7 d 5 5 5 1 5 5 5 5 3 
a 9 5 1 4 1 1 5 1 5 0 5 1 5 3 a 
a 8 7 a d 6 e d 6 d 6 f e b c 2 
a c 1 6 d 3 b d 1 7 9 7 b e b a 
8 3 c 5 3 c 4 5 4 1 4 1 4 5 2 a 
a a 9 5 2 d 5 1 3 a b 8 3 b a a 
8 0 4 1 2 b 9 6 c 2 8 2 a 8 2 a 
a c 5 6 c 2 a 9 3 c 6 e 8 2 a a 
8 5 1 7 d 2 c 4 6 d 1 5 6 e a a 
a d 0 7 d 2 b b d 5 4 5 5 5 2 a 
a d 0 7 9 4 2 a 9 5 5 1 1 3 8 2 
e d 0 7 a b c 2 a f f a a a a a 
9 1 4 3 c 4 3 c 2 f f 8 4 2 a a 
a a b a f f 8 3 c 1 5 6 b e a a 
a a a e b 9 6 e d 0 5 5 4 5 4 2 
e c 4 7 c 4 5 5 5 4 5 5 5 5 5 6 
