9 5 1 5 1 5 1 5 1 5 1 5 3 9 1 3 
8 5 0 5 0 5 0 5 0 5 0 5 0 2 a a 
8 5 0 5 0 5 0 5 0 5 0 5 2 a a a 
8 5 0 5 0 5 0 5 0 5 0 5 0 2 a a 
8 5 0 5 0 5 0 5 0 5 0 5 2 a a a 
8 5 0 5 0 5 0 5 4 5 4 5 4 6 a a 
8 5 0 5 0 5 0 7 9 5 5 5 5 5 6 a 
8 5 0 5 0 5 2 9 2 9 5 1 5 1 5 2 
8 5 0 5 0 5 2 c 6 c 1 4 1 4 1 2 
8 5 0 5 0 5 0 5 1 5 0 5 0 5 2 a 
8 5 0 5 0 5 0 5 0 5 0 5 0 5 0 2 
8 5 0 5 0 5 0 5 0 5 0 5 0 5 2 a 
8 5 0 5 0 5 0 5 0 5 0 5 0 5 0 2 
8 5 0 5 0 5 0 5 0 5 0 5 0 5 2 a 
8 1 4 1 4 1 4 1 4 1 4 1 4 1 4 2 
e c 5 4 5 4 5 4 5 4 5 4 5 4 5 6 
