9 1 5 3 9 5 1 5 5 3 b d 3 9 5 3 
a c 5 2 c 3 c 3 9 4 2 9 6 c 1 6 
8 3 b 8 5 4 3 a a b a a d 1 6 b 
a a c 2 9 5 2 e 8 6 c 6 9 6 9 2 
a a d 2 8 3 a 9 6 9 5 3 a 9 6 a 
a 8 5 2 a a a a d 4 7 8 6 c 7 a 
8 0 3 e e e a a d 5 7 a d 3 9 2 
a a 8 5 5 5 6 8 1 5 5 4 7 8 6 a 
e a a d 1 7 d 4 2 9 5 1 5 4 3 e 
b a 8 1 6 9 5 7 8 4 1 6 9 5 4 3 
e 8 2 c 3 8 5 5 4 5 4 1 4 1 7 e 
d 2 e d 2 c 5 5 1 5 5 2 d 4 5 3 
9 4 3 9 6 9 5 5 2 d 1 4 5 1 5 6 
8 1 4 2 9 6 9 7 c 3 c 3 9 6 9 7 
a a 9 4 4 5 2 f 9 4 5 4 2 d 2 b 
e c 4 5 5 5 4 5 4 5 5 5 4 5 4 6 
