9 5 5 5 5 5 5 5 1 5 5 3 9 5 5 3 
c 5 3 9 5 5 5 5 6 9 3 a a 9 5 6 
9 5 6 c 5 3 9 5 3 a a a a a 9 3 
8 5 3 9 1 6 c 3 a a a a a a a a 
a 9 6 a c 5 3 a a a c 6 a a a a 
a a 9 4 5 3 c 6 a c 5 5 6 a a a 
a c 6 9 5 6 9 5 4 5 1 5 5 2 a a 
a 9 3 a 9 3 8 1 3 9 6 9 3 a a a 
a a c 6 a c 6 c 6 c 5 6 a a a a 
a c 5 3 c 3 9 5 3 b 9 5 6 a a a 
8 5 3 c 5 2 c 5 6 8 2 9 3 c 6 a 
8 3 a 9 7 c 5 5 5 6 c 6 c 5 3 a 
a a c 4 5 5 5 5 5 3 9 5 5 5 2 a 
a 8 1 5 3 9 5 5 3 a a 9 5 7 a a 
a a c 5 6 c 5 1 6 c 6 a 9 5 6 a 
e c 5 5 5 5 5 4 5 5 5 4 4 5 5 6 
