b 9 3 9 3 9 3 9 5 7 9 5 5 5 1 7 
a a a a a a a 8 5 5 0 5 5 3 a b 
a a 8 2 8 2 a c 1 5 4 1 1 6 a a 
8 2 a a a a a d 0 5 3 e e 9 6 a 
a a c 6 e 8 0 5 4 5 4 7 9 2 f a 
a 8 3 9 3 a 8 5 5 7 d 5 2 c 3 a 
a a a a a a 8 5 5 5 5 3 a f a a 
a a c 6 c 6 a 9 1 5 3 e 8 5 4 6 
a a 9 1 1 1 2 c 6 b c 5 0 5 1 3 
a a a a a a 8 5 5 4 5 7 a f a a 
a a c 4 4 4 0 5 5 7 d 5 2 9 6 a 
a 8 3 9 3 b 8 5 1 5 1 7 c 2 f a 
a a a a a a a d 0 5 6 b b c 3 a 
a a c 6 c 0 2 9 4 5 1 4 4 3 a a 
a a 9 5 5 6 a 8 5 5 0 5 5 6 a e 
e e c 5 5 5 6 c 5 7 c 5 5 5 4 7 
