9 5 5 5 5 5 5 5 5 5 5 5 5 5 5 3 
a d 5 5 5 5 5 5 1 7 9 5 5 5 3 a 
8 5 1 5 5 1 5 1 6 9 4 1 5 5 2 a 
a b a d 3 e 9 6 9 6 9 6 9 5 2 a 
a a c 3 c 1 6 9 6 9 6 b 8 7 a a 
a a b c 3 a 9 6 9 6 9 4 6 9 2 a 
a a c 3 e a a d 4 5 4 3 9 6 a a 
a c 5 4 5 6 8 1 3 9 3 c 2 d 2 a 
a 9 5 5 5 3 a c 6 a 8 7 8 7 a a 
a a 9 5 7 a a 9 3 a a d 2 d 2 a 
a a 8 5 5 2 a a a a 8 7 8 7 a a 
a 8 0 5 7 a a a a a a d 2 d 2 a 
a a e 9 5 2 a a a a 8 7 8 7 a a 
a a 9 4 7 a a a a a a d 2 d 2 a 
a a c 5 5 4 4 6 c 6 c 3 8 5 6 a 
e c 5 5 5 5 5 5 5 5 5 4 4 5 5 6 
