9 1 5 1 5 1 5 1 3 9 3 9 1 1 5 3 
a a b a b a b a a e a a a a f a 
e 8 2 a a a a a c 5 4 6 a c 5 2 
b a a e a e a e 9 5 1 5 0 5 5 2 
a c 4 5 4 5 2 d 4 7 a f a 9 5 6 
8 3 9 5 1 5 6 9 5 1 4 5 2 8 5 3 
a c 2 b a 9 7 c 7 c 3 b a a d 6 
a b e 8 6 a b 9 3 9 4 2 e c 5 3 
8 6 9 6 9 4 2 c 4 4 7 e d 5 5 2 
a 9 6 d 0 7 a d 5 3 9 1 5 5 7 a 
8 4 5 3 c 1 6 9 5 6 a a d 5 5 2 
c 5 7 a d 4 1 6 9 5 2 8 5 5 7 a 
9 5 5 4 1 1 6 9 4 7 a a d 5 5 2 
a 9 5 3 a a 9 6 d 1 6 8 5 1 7 a 
a a d 6 a 8 6 9 7 c 3 c 5 4 5 2 
e c 5 5 6 c 5 4 5 5 4 5 7 d 5 6 
