9 1 1 1 1 1 1 1 1 1 1 1 1 1 1 3 
8 0 0 0 0 0 0 0 0 0 0 0 0 0 0 2 
c 4 4 4 4 4 4 4 4 4 4 4 4 0 0 2 
9 5 1 5 5 5 5 1 5 1 5 1 3 8 0 2 
8 3 a b d 1 7 c 5 4 5 6 a 8 0 2 
a e a c 5 4 1 1 5 1 1 3 a 8 0 2 
8 5 0 5 3 d 6 c 5 2 e 8 6 8 0 2 
c 1 4 1 4 1 7 9 3 e 9 6 b 8 0 2 
9 4 1 4 1 4 3 c 2 9 6 b a 8 0 2 
c 1 4 1 4 1 4 3 a c 3 a a 8 0 2 
9 4 1 4 1 4 1 6 8 3 c 2 e 8 0 2 
c 5 4 1 4 5 6 b a c 3 c 3 8 0 2 
9 5 1 4 1 7 b a a 9 4 5 6 8 0 2 
a 9 4 5 6 b a c 4 0 3 b b 8 0 2 
a 8 3 9 5 6 c 5 7 a c 0 2 8 0 2 
e e c 4 5 5 5 5 7 e d 6 e c 4 6 
