9 1 5 5 5 7 9 5 5 3 d 1 1 1 5 3 
8 2 9 5 1 3 a 9 3 c 3 c 4 6 b e 
8 2 a b a c 6 8 0 3 c 5 5 5 4 3 
8 6 a a 8 7 9 0 0 6 9 5 5 5 5 2 
a 9 6 e a d 0 0 6 9 6 9 5 5 5 2 
a c 5 3 c 3 c 6 9 6 9 6 9 1 7 a 
8 1 7 8 1 6 9 5 6 f a b c 6 9 2 
8 6 9 6 c 3 a 9 3 9 2 8 5 5 6 a 
e 9 6 9 3 a 8 4 6 a a a 9 5 3 a 
9 6 9 0 2 a c 5 5 6 c 6 a f a a 
a d 0 0 2 a d 7 9 5 5 3 8 7 a a 
8 7 8 4 6 a 9 3 a 9 7 c 2 b c 6 
a d 6 9 1 4 6 c 6 a b f a 8 1 3 
8 1 5 6 c 3 d 1 1 2 8 5 6 8 0 2 
a a d 5 7 8 3 c 4 6 a 9 1 0 0 2 
e c 5 5 5 6 c 5 5 5 6 c 4 4 4 6 
