9 5 1 5 1 5 3 9 3 9 5 5 5 1 5 3 
a b a b a b a a 8 0 7 9 3 8 5 2 
a a a a a a a a e c 7 a c 0 5 2 
a a e a e a c 0 5 7 9 6 d 4 3 a 
8 0 1 0 5 4 3 a d 1 4 3 9 5 6 a 
e e e e 9 5 6 c 7 a d 0 6 b b a 
9 5 5 5 6 b b d 5 0 5 2 b c 0 6 
a b b b d 2 a 9 3 a b e a d 4 3 
8 0 0 0 5 0 6 c 4 6 c 5 0 5 5 6 
e e e e 9 4 3 9 5 7 9 3 c 5 5 3 
9 5 7 9 0 3 8 0 1 7 a 8 5 5 7 a 
a 9 3 a e 8 6 a e 9 6 a d 5 5 2 
8 6 c 0 5 6 d 0 7 a d 0 5 5 7 a 
c 3 b c 3 b d 0 7 a d 2 d 5 5 2 
9 0 2 9 6 a d 0 7 a d 0 5 5 7 a 
e e c 4 5 6 d 4 5 6 d 4 5 5 5 6 
