b 9 3 b 9 5 3 9 5 5 1 5 7 9 5 3 
a a a e a f 8 2 d 7 a d 7 a b a 
a 8 4 1 4 3 a 8 1 5 4 5 3 a a a 
a a 9 6 9 4 2 a c 5 5 1 2 a a a 
a a a 9 0 5 2 c 7 9 5 2 8 2 a a 
8 2 c 2 c 1 4 5 7 8 5 2 a a a a 
a a 9 6 f a 9 5 5 2 9 6 a a e a 
a a c 5 5 6 a 9 3 8 4 5 6 c 5 6 
a a 9 5 5 3 8 4 6 8 1 5 3 9 5 3 
a a c 3 f a c 5 5 2 c 3 a a b a 
a a 9 2 9 4 1 5 7 8 5 2 a a a a 
8 2 a c 0 5 2 9 7 c 5 2 8 2 a a 
a a c 3 c 1 2 a 9 5 5 4 2 a a a 
a 8 1 4 1 6 a 8 4 5 1 5 6 a a a 
a a a b a f 8 2 d 7 a d 7 a e a 
e c 6 e c 5 6 c 5 5 4 5 7 c 5 6 
