9 3 9 3 9 7 9 1 1 5 5 5 5 5 5 3 
a 8 6 8 4 1 2 e 8 5 5 5 5 5 3 a 
8 4 1 2 9 2 c 5 6 9 5 5 5 5 6 a 
a 9 2 8 2 c 1 5 5 4 5 5 5 5 3 a 
8 2 8 2 c 7 8 5 5 5 5 5 5 5 6 a 
a 8 2 c 1 5 6 9 5 5 5 5 5 5 5 2 
8 6 c 7 c 1 3 a d 3 9 3 9 3 9 2 
8 5 5 5 5 6 a 8 3 a a c 6 c 2 a 
a 9 5 5 5 3 e c 6 a c 5 5 3 a a 
a a 9 5 5 6 9 5 5 4 5 1 5 6 a a 
c 2 a 9 5 5 4 5 5 5 3 c 5 5 6 a 
9 2 a a 9 5 5 5 5 5 4 5 5 5 3 a 
a a a a c 5 5 5 5 5 3 9 5 5 4 2 
a a a 8 5 5 5 5 5 3 a c 5 5 3 a 
a a c 6 9 1 5 5 5 6 a 9 5 5 6 e 
e c 5 5 6 c 5 5 5 5 4 4 5 5 5 7 
