b 9 1 5 5 5 5 5 5 5 5 5 5 1 1 7 
8 6 a 9 5 5 3 9 5 5 3 9 3 e c 3 
8 5 2 a 9 3 c 6 9 3 c 6 c 5 3 a 
8 5 6 c 6 c 5 5 6 c 5 5 3 9 6 a 
a 9 3 9 3 9 1 3 9 1 3 9 6 c 3 a 
a a c 6 c 6 e c 6 e c 6 d 1 6 a 
a c 3 9 1 7 9 1 5 3 9 3 d 0 7 a 
a 9 6 a c 3 a 8 3 c 6 c 5 0 7 a 
a a 9 6 9 6 a c 6 b 9 1 5 4 7 a 
a c 6 9 4 7 c 5 5 4 6 c 5 5 3 a 
a 9 5 6 9 3 b 9 3 b 9 1 7 9 6 a 
a c 3 9 6 c 0 6 c 0 6 a b c 3 a 
a 9 6 c 3 b e 9 3 e 9 6 8 5 6 a 
a a 9 5 6 8 5 6 c 5 6 b a 9 1 2 
8 6 a b b c 5 5 5 5 5 4 6 e e a 
e d 4 4 4 5 5 5 5 5 5 5 5 5 5 6 
