9 5 5 1 1 5 5 5 5 5 1 5 5 5 1 3 
a 9 5 2 c 1 7 d 1 5 0 5 5 1 6 a 
a 8 7 8 7 c 3 9 6 d 0 5 1 4 7 a 
a c 5 0 5 3 c 0 5 5 4 7 a b b a 
8 3 d 4 3 c 7 c 1 5 7 9 4 4 2 a 
a a 9 5 0 5 5 3 8 5 1 6 b b a a 
8 0 4 1 2 b 9 6 c 5 4 1 4 0 2 a 
a c 1 6 c 6 e 9 3 d 5 4 5 2 e a 
8 5 0 5 5 5 3 c 2 9 5 5 1 4 3 a 
8 5 0 5 5 3 a b c 4 7 d 6 d 6 a 
8 5 0 5 1 0 4 0 5 1 5 1 3 9 3 a 
c 5 0 3 e e d 6 d 4 7 e c 2 a a 
9 1 2 a b b f 9 7 9 7 b b a a a 
a a 8 0 4 0 5 0 5 0 5 0 2 a e a 
a a a a b 8 7 e d 0 5 2 c 4 7 a 
e c 4 4 4 4 7 d 5 4 5 4 5 5 5 6 
