b d 5 5 5 5 1 5 1 5 5 5 5 5 5 3 
a b d 5 5 5 2 9 6 d 5 5 5 5 1 2 
a a b d 5 5 0 4 1 5 5 5 7 9 2 a 
a a a 9 5 5 4 7 c 5 5 7 9 2 a a 
a a a a 9 5 5 1 1 5 7 9 2 a 8 2 
a a 8 2 a 9 5 6 c 5 1 2 a 8 2 a 
a 8 2 a a a 9 5 5 3 a a 8 2 a a 
8 6 a e 8 6 e 9 3 a c 0 6 a a a 
a 9 4 3 8 3 9 4 6 8 1 0 1 0 0 2 
a c 3 a a 8 6 9 5 6 a a a a a a 
a 9 4 2 a c 5 2 9 5 6 e e e e a 
a c 3 a c 5 5 4 4 5 7 d 5 1 1 2 
a 9 2 a 9 3 d 3 9 1 1 7 b a a a 
a a c 0 6 c 5 6 a a a b a e a a 
a 8 5 4 5 5 5 1 0 0 0 2 a d 6 a 
e c 5 5 5 5 5 6 e e e c 4 5 5 6 
