f 9 5 7 f d 1 3 b 9 1 3 f d 3 f 
b 8 1 3 b 9 6 c 4 6 e c 1 1 2 b 
c 2 e c 4 6 9 1 1 7 f 9 6 e c 2 
9 6 f d 3 9 6 e c 1 3 8 7 f d 2 
8 7 9 1 6 8 7 f d 2 c 4 1 3 9 6 
c 1 2 8 7 c 1 1 1 2 f d 2 c 4 3 
9 6 e c 3 9 6 e e c 1 1 2 f d 2 
8 7 f d 2 8 5 1 3 d 2 e 8 3 9 6 
8 3 9 1 2 8 7 c 6 d 2 9 6 c 4 3 
a 8 6 e e c 3 b b 9 2 8 7 f d 2 
e 8 7 f d 3 c 4 4 6 c 6 b b 9 2 
b 8 1 3 9 2 d 1 1 1 7 f 8 4 2 e 
a a e c 2 c 1 6 e c 1 3 a d 4 3 
8 2 f 9 6 f c 3 f d 2 e 8 1 1 2 
a a b 8 3 b 9 6 b 9 6 f a e e a 
e c 4 6 c 4 6 d 4 4 5 5 4 5 5 6 
