d 5 5 5 5 1 5 5 5 3 9 5 1 5 5 3 
9 5 5 5 5 6 d 5 7 a e f a b b a 
a 9 5 5 1 5 5 5 5 4 5 5 6 a e a 
a a 9 3 a 9 5 5 5 3 9 5 5 2 9 6 
a a c 6 a a d 5 7 a a b b a a b 
a a d 5 6 c 5 5 5 6 a a a a a a 
a c 5 5 5 5 1 5 5 1 2 a a 8 6 a 
c 5 5 1 5 7 a 9 3 a a a a a b a 
b d 7 a 9 5 6 c 2 a a a a a a a 
8 5 5 6 a d 5 5 4 6 e a e a e a 
a 9 5 5 4 5 5 5 3 9 5 4 5 4 5 2 
a a d 5 5 5 5 7 a a d 5 5 5 7 a 
a c 5 5 5 1 5 5 4 2 d 5 5 5 5 6 
a d 5 5 7 e d 5 7 c 5 5 5 5 5 3 
8 5 5 1 5 5 5 5 5 5 5 5 5 3 f a 
e d 7 c 5 5 5 5 7 d 5 5 5 4 5 6 
