9 5 3 9 5 5 5 5 5 5 3 9 5 5 5 3 
a b c 6 9 5 5 1 3 b c 6 9 5 3 a 
a 8 5 7 a 9 7 a a 8 5 5 6 b e a 
a c 5 3 a c 3 a c 4 5 5 1 0 3 a 
a 9 5 6 8 5 4 4 3 b d 7 a a a a 
a a 9 3 c 7 9 3 a a d 3 a a a a 
a 8 6 c 1 3 a c 4 6 b a a a a a 
c 4 5 3 e c 6 9 1 5 2 a a c 6 a 
d 1 5 6 9 5 7 c 6 f a a c 1 3 a 
d 0 5 5 2 d 5 3 b f a c 5 2 a a 
b c 3 9 0 1 5 6 a d 4 5 5 2 a a 
a 9 6 a a 8 5 5 6 9 1 5 7 a a a 
a c 1 6 a 8 5 5 3 a c 5 5 6 a a 
c 3 e 9 6 e 9 3 a a d 5 5 5 2 a 
9 0 5 4 5 5 6 c 6 c 5 5 5 5 6 a 
e c 5 5 5 5 5 5 5 5 5 5 5 5 5 6 
