9 5 5 5 5 5 5 5 5 5 5 5 5 5 5 3 
a 9 5 5 5 5 5 5 5 5 5 5 1 5 7 a 
a 8 5 5 5 5 5 5 5 5 5 5 4 5 7 a 
a a d 5 5 5 5 5 5 5 5 5 5 5 3 a 
a a 9 5 1 5 5 5 7 9 1 5 5 5 2 a 
a a a f c 3 d 5 1 6 8 3 f b a a 
c 4 4 1 1 4 1 7 a b a c 3 e a a 
9 1 5 6 8 3 a 9 2 a c 7 c 3 a a 
e a 9 5 2 8 6 c 6 a b b b c 2 a 
b a a b c 2 9 5 3 c 0 4 4 5 2 a 
8 4 0 4 5 6 8 7 8 1 6 9 1 1 6 a 
a 9 2 b 9 7 8 7 e a 9 6 a 8 5 6 
a a c 0 4 7 8 7 9 6 8 7 8 4 3 b 
a a b c 3 d 2 9 4 3 a d 2 f c 2 
a a a b 8 3 8 6 b a 8 7 e 9 7 a 
e c 4 4 6 c 4 5 6 c 4 5 7 c 7 e 
