9 1 1 1 1 1 1 1 1 1 1 1 1 1 1 3 
8 0 0 0 0 0 0 0 0 0 0 0 0 0 0 2 
8 0 0 0 0 0 0 0 0 0 0 0 0 0 0 2 
8 0 0 0 0 0 0 0 0 0 0 0 0 0 0 2 
8 0 0 0 0 0 0 0 0 0 0 0 0 0 0 2 
c 4 4 4 4 4 4 4 4 0 0 0 0 0 0 2 
9 5 5 5 5 3 9 5 3 8 0 0 0 0 0 2 
a 9 5 5 5 6 a 9 2 8 0 0 0 0 0 2 
a a 9 5 3 d 2 c 6 8 0 0 0 0 0 2 
a a c 3 c 3 c 5 3 8 0 0 0 0 0 2 
a a d 4 3 c 5 5 6 8 0 0 0 0 0 2 
a a 9 3 a 9 1 1 1 0 0 0 0 0 0 2 
a a a c 6 8 0 0 0 0 0 0 0 0 0 2 
a a a 9 3 8 0 0 0 0 0 0 0 0 0 2 
a a c 6 a 8 0 0 0 0 0 0 0 0 0 2 
e c 5 5 6 c 4 4 4 4 4 4 4 4 4 6 
