d 1 5 5 5 5 5 5 5 5 5 5 5 5 5 3 
9 6 d 1 5 5 5 5 5 5 5 5 5 1 3 a 
c 3 9 6 9 5 3 9 5 3 d 1 5 2 a a 
9 6 c 1 6 9 6 a b c 3 c 3 c 2 a 
a 9 5 2 d 0 7 a 8 3 c 3 8 3 a a 
a c 3 e 9 6 9 2 a c 3 c 2 a a a 
a 9 6 d 0 7 a e c 3 c 3 c 6 a a 
c 6 d 1 6 9 6 9 1 4 7 a 9 5 2 a 
b 9 5 0 7 c 3 c 6 9 5 6 c 3 a a 
a a 9 6 9 1 4 5 5 4 1 3 9 6 a a 
a c 0 7 a a d 1 5 1 2 a c 3 a a 
8 1 6 9 0 6 9 4 1 2 8 6 9 6 a a 
a 8 3 a a 9 4 1 2 8 4 3 c 3 a a 
8 2 a a e c 1 2 8 4 5 6 d 2 a a 
a a a c 1 5 2 c 6 9 3 9 3 c 6 a 
e c 4 5 4 5 4 5 5 6 c 6 c 5 5 6 
