9 5 5 5 5 5 5 5 1 5 1 5 5 5 5 3 
a 9 5 5 5 5 5 5 4 5 2 d 3 d 3 a 
8 2 9 5 5 1 3 d 5 5 4 3 c 3 c 2 
a a a 9 5 2 c 5 5 5 3 c 3 8 1 2 
a a a a 9 4 5 1 5 5 4 3 a a a a 
a a a a a 9 5 4 5 5 3 a a a a a 
a a a 8 2 a 9 5 5 3 a a a a 8 2 
a c 2 a 8 0 2 9 3 a a a a a a a 
a 9 2 a a a a 8 6 a c 2 8 0 2 a 
8 2 a a a a e 8 5 4 1 2 a a 8 2 
a a a a a a d 4 5 5 2 a c 2 a a 
8 2 a a a c 5 5 5 5 4 6 9 0 2 a 
a a a a c 3 d 5 5 5 1 5 6 a 8 2 
8 2 8 0 5 4 5 5 5 5 2 d 5 6 a a 
a c 2 a b b d 5 5 5 4 5 5 5 4 2 
e d 4 4 4 4 5 5 5 5 5 5 5 5 5 6 
