d 1 5 1 5 1 5 1 5 1 5 1 5 1 5 3 
f a f a f a f a f a f a f a f a 
9 4 1 4 1 4 1 4 1 4 1 4 1 4 1 6 
a f a f a f a f a f a f a f a f 
c 1 4 1 4 1 4 1 4 1 4 1 4 1 4 3 
f a f a f a f a f a f a f a f a 
9 4 1 4 1 4 1 4 5 0 5 0 5 0 5 2 
a b a b a b 8 1 3 a b a b a b a 
a e a e a e a c 4 2 e a e a e a 
c 1 4 1 4 1 4 1 5 0 5 0 5 0 5 2 
f a f a f a f a f a f a f a f a 
9 4 1 4 1 4 1 4 1 4 1 4 1 4 1 6 
a f a f a f a f a f a f a f a f 
8 1 4 1 4 1 4 1 4 1 4 1 4 1 4 3 
a a f a f a f a f a f a f a f a 
e c 5 4 5 4 5 4 5 4 5 4 5 4 5 6 
