9 5 3 9 5 3 9 5 5 5 5 5 5 5 1 3 
a 9 6 a 9 6 8 5 5 3 9 5 3 9 6 a 
a c 3 a 8 5 4 5 5 6 a b 8 6 9 6 
a 9 6 a a 9 5 5 5 3 a c 4 5 6 b 
a c 5 6 a a 9 5 5 2 c 3 9 5 5 2 
c 5 5 3 e a a 9 5 4 5 2 c 1 1 6 
9 5 7 a 9 6 e c 5 5 3 c 5 2 c 3 
a 9 3 a c 1 7 9 3 d 4 5 5 6 9 2 
a a a a 9 4 5 4 6 9 5 5 5 1 6 a 
a a a a a 9 7 9 3 c 5 5 1 4 1 6 
a 8 2 a a a 9 6 a b 9 1 4 7 c 3 
8 2 a a a a a 9 6 a a c 3 b 9 6 
e a a a a a a 8 5 6 c 3 8 2 c 3 
9 2 c 6 c 6 e a 9 5 5 6 a 8 3 a 
a 8 5 5 5 5 5 2 c 5 5 5 6 e c 2 
e c 5 5 5 5 5 4 5 5 5 5 5 5 5 6 
