9 1 1 1 1 1 1 1 1 1 1 1 1 1 1 3 
8 0 0 0 0 0 0 0 0 0 0 0 0 0 0 2 
8 0 0 0 0 0 0 0 0 0 0 0 0 0 0 2 
c 4 4 4 4 4 4 4 4 4 4 4 0 0 0 2 
9 3 9 3 9 1 1 1 5 1 1 3 8 0 0 2 
a c 6 c 6 a e a b a e a 8 0 0 2 
8 5 3 9 7 8 5 4 0 4 1 6 8 0 0 2 
8 5 4 6 d 4 1 1 2 b c 3 8 0 0 2 
a b 9 3 b 9 6 8 6 a 9 2 8 0 0 2 
c 4 6 a c 0 7 8 3 c 6 a 8 0 0 2 
9 5 5 2 d 0 5 2 8 7 d 6 8 0 0 2 
a 9 3 c 7 e 9 2 8 3 9 3 8 0 0 2 
a a c 3 9 3 a a a 8 6 a 8 0 0 2 
a c 3 c 6 c 6 c 4 0 3 e 8 0 0 2 
8 1 4 1 3 9 5 5 5 6 a b 8 0 0 2 
e c 5 6 c 4 5 5 5 7 c 6 c 4 4 6 
