d 5 5 5 5 5 5 3 b 9 1 5 5 5 3 b 
9 5 7 9 3 9 1 0 0 2 c 5 3 9 0 2 
8 5 3 a a a a a a a 9 5 6 e e a 
c 7 a a a a a e c 6 c 1 3 9 3 a 
9 5 4 2 8 0 2 b 9 5 5 2 a a a a 
8 5 7 a a a a a c 1 1 2 c 6 c 2 
8 1 3 a a a a c 5 2 a a 9 5 5 6 
e a a a a a a 9 1 2 c 6 c 5 1 7 
d 4 4 6 c 4 2 c 6 c 5 7 d 5 0 3 
d 5 1 3 9 5 0 1 5 5 5 1 5 5 2 a 
9 3 a a 8 3 a 8 5 5 5 0 5 5 6 a 
a 8 2 a e a a c 5 5 5 4 5 5 3 a 
a e a c 5 6 a 9 5 5 5 1 5 5 6 a 
8 7 c 5 1 5 2 8 5 3 b 8 5 3 b a 
8 3 b d 4 3 a 8 5 2 a a b a a a 
e c 4 5 5 6 e e d 4 4 6 c 4 6 e 
