d 5 1 3 9 3 b 9 3 9 1 3 9 5 5 3 
9 5 2 8 6 c 2 a a a a 8 0 3 9 2 
8 3 a 8 1 3 a a a a a a a a a a 
a e a e e c 0 6 c 4 6 a a c 2 a 
8 3 c 7 d 3 e 9 1 1 1 6 c 3 c 6 
e a 9 5 1 6 b a a a 8 5 7 c 5 3 
9 6 c 5 4 5 6 c 6 e c 5 3 9 5 2 
8 5 5 5 5 7 9 1 3 9 5 5 2 c 3 e 
a 9 5 5 5 3 a c 6 c 5 1 0 3 8 3 
a a d 5 5 2 a b 9 3 b a e c 2 a 
a 8 5 1 7 c 6 8 6 8 2 8 5 3 8 2 
a e d 4 5 5 5 4 5 6 c 6 d 2 a a 
a d 5 1 3 9 5 3 b 9 5 5 3 e c 2 
8 5 3 a c 6 b 8 6 c 5 5 4 3 b a 
a b a 8 3 9 4 4 3 d 5 1 1 6 c 2 
e c 4 6 c 4 5 7 c 5 5 6 c 5 5 6 
