9 5 5 5 5 5 5 5 5 5 1 1 1 1 3 b 
a 9 5 5 5 5 5 5 5 3 a e a e 8 6 
a c 5 5 1 5 5 7 b a a 9 4 3 c 3 
8 5 5 5 4 5 5 3 8 2 a 8 1 4 3 a 
c 5 5 5 5 5 3 a a 8 6 c 6 b e a 
d 1 5 5 5 5 6 e a c 1 5 5 4 5 2 
d 4 1 5 5 7 9 7 8 1 4 5 5 5 3 a 
d 1 6 9 5 3 a 9 2 c 5 5 5 7 a a 
9 6 9 6 9 6 a c 6 b d 5 1 3 a a 
a 9 6 9 6 9 0 5 5 6 9 3 a 8 2 a 
8 6 9 6 b a e 9 3 b a a a a a a 
e 9 6 d 6 e 9 6 a a a a a a a a 
9 6 9 3 f 9 6 9 6 a a a a a a a 
8 5 2 a 9 6 9 6 9 2 a a a a a a 
a b a a e 9 6 b a 8 2 a a c 6 a 
e c 6 c 5 4 7 e e e e c 4 5 5 6 
