9 5 5 5 5 5 5 1 1 5 5 5 5 5 1 7 
c 3 d 3 9 3 9 6 c 5 1 7 d 5 0 7 
b c 3 a a e c 3 d 1 6 9 3 d 0 7 
8 3 c 2 c 3 9 6 9 6 9 6 a d 0 7 
a c 3 c 3 a c 3 e 9 6 9 2 d 0 7 
a b c 3 c 2 b c 1 6 9 6 e d 0 7 
8 4 3 c 3 c 2 d 6 d 4 5 3 d 0 7 
8 7 c 7 8 7 a 9 3 b 9 3 a d 0 7 
8 7 9 7 c 7 a 8 6 c 6 c 6 d 0 7 
a 9 6 9 7 9 6 a b b d 1 7 d 0 7 
8 2 b a 9 6 b c 2 c 3 c 3 d 0 7 
a c 6 8 6 b c 3 c 3 c 3 c 5 0 7 
8 3 9 6 b c 3 c 3 c 3 c 3 d 0 7 
e 8 4 1 4 3 c 3 c 3 c 3 c 5 0 7 
9 6 9 4 7 c 7 c 3 c 3 c 3 d 0 7 
e d 4 5 5 5 5 5 4 5 4 7 c 5 4 7 
