9 5 1 5 1 5 1 5 3 b b b 9 5 5 3 
a d 4 5 4 5 2 9 2 8 2 a a 9 3 a 
a 9 5 5 1 5 2 a a a a a a e a a 
a c 1 7 c 5 4 6 c 6 8 2 c 5 6 a 
c 3 c 5 5 5 5 5 5 3 e c 1 5 5 6 
d 4 1 7 9 5 5 5 5 4 3 d 4 5 1 7 
9 5 4 7 a b 9 5 1 3 8 3 9 5 4 7 
c 5 5 3 a a a 9 2 a a a c 5 1 3 
9 5 5 6 c 2 a c 6 a a a 9 5 6 a 
c 5 5 1 7 c 0 5 5 6 a a 8 1 1 2 
9 5 5 0 5 3 c 1 5 7 a a a a a e 
8 5 3 a b a b c 5 7 e a c 2 8 3 
c 7 a e a 8 2 9 3 b b a b a a a 
9 5 4 1 6 a a a a 8 2 c 2 a 8 2 
a 9 7 a d 2 a a a a 8 3 c 6 e a 
e c 5 4 5 6 c 6 c 6 e c 5 5 5 6 
