9 1 1 1 1 1 1 1 1 1 1 1 1 1 1 3 
8 0 0 0 0 0 0 0 4 4 0 0 0 0 0 2 
8 0 0 0 0 0 0 2 b b c 4 4 4 0 2 
8 0 0 0 0 0 0 2 8 4 5 1 5 3 8 2 
c 4 4 4 4 4 4 6 a 9 3 e b a c 6 
b d 5 7 b d 1 5 4 6 8 5 2 c 5 3 
8 7 d 1 4 1 4 5 5 5 6 b c 3 9 2 
a d 7 a b a b 9 3 f b e b a a e 
a 9 5 2 e c 2 c 4 5 4 1 4 4 0 7 
a a b a d 5 4 3 9 1 7 a d 3 a b 
c 2 a a 9 1 7 a 8 2 b 8 3 a e a 
b a 8 2 c 6 d 2 c 6 a a e 8 1 2 
e a e c 1 3 d 2 9 5 0 4 7 8 0 2 
9 4 1 7 a c 5 2 8 3 a 9 7 8 0 2 
a b c 5 2 9 5 2 e a 8 4 3 8 0 2 
e c 5 7 c 6 f c 5 6 e d 6 c 4 6 
