9 5 5 5 5 5 1 5 5 5 1 5 5 1 3 b 
8 5 1 5 1 1 6 d 1 3 e b b e a a 
8 7 e b e a b b e c 1 2 8 5 4 2 
8 7 b 8 7 e a c 3 b a c 6 b b a 
8 5 2 8 5 3 a b 8 6 c 5 1 2 8 6 
8 3 a a 9 6 8 4 2 b d 3 a c 4 3 
a a 8 2 a 9 2 d 4 2 9 4 0 3 9 2 
a a a e c 2 e 9 3 a a 9 6 8 6 a 
a c 6 9 3 c 7 8 6 a a a d 2 d 2 
8 5 5 2 a 9 3 a d 0 2 c 3 c 3 a 
a 9 5 6 e a a c 5 6 c 3 c 3 c 2 
a c 5 5 1 2 a 9 5 5 5 0 3 c 5 2 
a 9 5 5 6 c 6 e d 5 1 6 a 9 3 a 
a c 5 5 3 b 9 5 5 5 4 5 6 e a a 
a 9 5 5 6 a c 5 5 5 5 5 5 5 2 a 
e c 5 5 5 4 5 5 5 5 5 5 5 5 4 6 
