9 5 5 5 5 5 5 5 5 5 5 5 5 1 5 3 
a 9 5 1 5 5 5 5 5 3 9 3 d 4 3 a 
a c 3 8 5 5 5 1 7 c 6 a 9 5 6 a 
a 9 4 0 7 9 3 c 5 3 9 6 c 5 3 a 
a a d 6 9 6 8 1 7 a c 3 d 1 6 a 
a c 3 9 4 3 e c 3 c 3 c 3 c 3 a 
a b a a b e 9 5 4 3 c 3 c 3 a a 
a 8 2 c 0 3 a 9 1 2 d 0 7 a a a 
a e a b e a a c 6 a b c 3 c 6 a 
a b c 4 3 a e d 5 6 8 3 c 5 3 a 
a 8 5 5 6 c 5 1 5 3 a c 5 5 6 a 
a 8 7 9 3 b d 4 3 e c 5 5 5 3 a 
a c 5 6 c 0 7 d 4 3 9 5 5 5 6 a 
8 3 9 5 5 4 7 9 3 c 6 9 3 9 3 a 
a a c 5 5 5 5 6 c 5 5 6 c 6 c 2 
e c 5 5 5 5 5 5 5 5 5 5 5 5 5 6 
