d 1 1 5 1 5 1 5 3 9 5 5 1 1 5 3 
9 6 c 5 0 5 4 7 8 4 3 9 6 c 3 a 
a d 5 5 4 5 5 5 4 5 4 4 5 5 4 2 
8 5 5 5 5 5 5 5 5 5 5 5 5 5 5 2 
a d 5 5 5 5 5 5 5 5 5 5 5 5 1 2 
8 5 5 5 1 5 7 9 3 9 3 9 3 9 6 a 
a d 5 5 4 5 7 a c 6 c 6 c 6 9 6 
8 5 5 5 5 5 3 8 3 d 5 5 3 9 6 b 
e 9 3 9 5 1 2 c 6 9 5 5 6 8 3 a 
b e 8 4 1 2 8 5 5 0 7 d 1 6 a a 
a 9 4 1 2 8 4 5 3 c 1 7 c 3 c 2 
8 4 1 2 8 4 1 7 a 9 6 9 3 c 3 a 
c 1 2 8 0 5 6 b a c 3 a c 3 8 2 
9 2 8 6 a d 1 4 6 9 6 a b a e a 
a c 6 9 6 9 2 9 3 c 1 6 8 4 3 a 
e d 5 4 5 6 c 6 c 5 4 5 4 5 4 6 
