9 5 5 5 5 3 9 1 5 5 5 5 3 9 1 3 
a 9 3 9 3 a a 8 1 5 5 7 8 6 e a 
a a a a 8 6 a a 8 3 9 1 6 9 3 a 
a a 8 2 a b c 6 e a a 8 5 2 a a 
a 8 2 c 0 4 5 3 9 4 6 8 7 c 6 a 
a e c 5 6 9 3 a c 5 7 c 5 5 3 a 
c 5 1 1 5 2 a c 5 1 5 1 1 7 c 2 
d 3 a c 5 6 a 9 1 6 b e c 5 5 2 
9 0 2 9 5 3 a c 4 1 4 1 5 1 5 2 
a a e e b a c 5 7 e b e f e d 2 
a a d 1 0 6 d 5 5 5 4 1 1 1 7 a 
a c 1 2 c 1 1 5 5 5 5 2 a a 9 6 
c 5 6 a 9 6 8 5 5 5 1 6 a a 8 3 
9 3 b a c 5 6 9 5 3 c 1 2 a e e 
a 8 4 4 5 5 5 6 d 2 d 2 a c 5 7 
e c 5 5 5 5 5 5 5 4 5 6 c 5 5 7 
