9 5 5 5 1 5 3 9 3 9 5 1 5 1 1 3 
8 5 5 7 c 3 c 2 8 6 9 6 9 6 a a 
a 9 1 5 3 c 3 c 6 9 6 9 4 5 2 a 
c 6 c 5 4 3 c 3 9 6 9 0 5 1 6 a 
9 5 5 5 5 4 7 c 6 9 6 a 9 6 9 2 
8 1 5 5 5 5 3 d 5 0 5 0 6 9 6 a 
a a 9 5 5 3 a d 5 0 1 6 9 6 9 6 
a a a d 3 a a 9 1 2 a 9 6 9 4 3 
c 2 c 5 6 a a c 6 e e c 3 c 1 6 
d 0 5 5 5 6 c 5 5 5 3 b c 3 c 3 
9 0 5 5 3 f 9 5 5 3 a 8 3 c 1 6 
a 8 5 5 0 3 a 9 3 a a a 8 3 c 3 
a 8 5 3 a a a a e a a a a c 3 a 
8 2 f a a a a c 5 6 a a 8 3 8 2 
a a d 4 0 0 0 5 5 5 2 8 2 c 2 a 
e c 5 5 6 e c 5 5 5 4 6 c 5 4 6 
