9 5 5 5 1 5 5 5 5 5 5 5 5 5 5 7 
a 9 1 5 6 d 1 5 5 5 5 5 1 5 7 b 
8 6 a 9 7 9 6 9 3 d 1 1 4 1 7 a 
8 7 a a 9 6 9 2 8 1 6 c 3 8 5 2 
e b a 8 6 d 2 e e 8 1 5 4 4 5 2 
b a c 4 1 7 8 5 7 e a d 5 5 7 a 
c 0 5 5 4 3 8 5 5 3 8 1 1 5 5 6 
b a 9 1 3 a a 9 3 a a a c 5 5 3 
8 6 8 0 2 a a c 2 a a c 1 5 7 a 
a b c 4 6 a a 9 4 2 a b 8 3 9 6 
8 0 1 1 1 6 a e d 6 a 8 6 a c 3 
a a a a e d 4 7 b 9 6 8 7 a 9 6 
a a a c 5 5 5 3 c 4 5 4 5 4 0 3 
8 2 8 7 b 9 5 4 5 1 5 5 1 3 a a 
a 8 4 5 4 4 5 5 5 6 d 5 6 a c 2 
e c 5 5 5 5 5 5 5 5 5 5 5 4 5 6 
