9 5 3 9 5 5 5 5 5 5 5 5 5 5 1 3 
a b c 6 b b b b 9 3 9 3 9 3 a a 
a c 3 9 4 0 0 0 2 c 6 c 6 c 6 a 
a 9 2 a b e a e e 9 5 7 9 3 b a 
a a c 6 8 7 e 9 3 8 5 5 6 c 2 a 
a c 5 5 4 5 5 6 a 8 7 9 5 5 6 a 
8 5 7 9 5 5 5 7 c 0 7 8 5 5 3 a 
8 5 7 a 9 5 3 9 3 e 9 4 5 5 2 a 
8 5 7 a a d 2 c 4 3 e 9 5 7 a a 
8 3 9 4 4 5 6 b b c 5 2 d 5 2 a 
a e 8 1 5 5 5 6 8 5 7 c 1 3 a a 
c 5 2 8 1 5 5 1 4 5 5 7 a a a a 
9 3 a a 8 5 7 8 5 5 7 b c 2 a a 
a 8 4 6 c 5 3 a b d 5 0 3 c 2 a 
a a 9 5 5 3 a c 6 9 3 a 8 7 e a 
e c 4 5 5 6 c 5 5 6 c 4 4 5 5 6 
