9 5 7 9 3 9 1 7 9 5 3 d 1 5 1 3 
a b 9 6 c 6 8 5 2 9 4 7 a d 2 a 
a 8 6 9 7 9 6 b e c 3 d 4 5 6 a 
a c 5 2 9 6 9 4 5 5 4 3 b b b a 
8 5 7 a e d 4 5 5 1 3 a a 8 4 2 
a 9 5 4 5 7 9 3 9 6 a a c 2 b a 
a 8 7 9 5 7 a c 6 9 6 c 3 c 2 a 
a c 5 0 5 7 a 9 3 c 1 5 2 d 4 2 
8 5 7 a d 3 c 4 6 b e b e 9 3 a 
8 7 d 4 5 0 5 1 5 2 9 4 1 6 a a 
c 5 5 5 3 e b e b c 6 b e b c 2 
9 5 7 9 6 d 0 5 2 d 3 8 3 8 5 6 
c 5 1 6 d 3 c 3 a b 8 6 c 6 d 3 
9 7 8 3 9 0 5 6 a a 8 7 9 1 5 6 
8 5 6 a e c 5 3 c 4 6 9 6 a d 3 
e d 5 4 5 5 5 4 5 5 5 4 5 4 5 6 
