9 5 3 9 5 5 5 5 3 9 3 9 3 9 5 3 
8 3 8 2 9 7 9 3 e a a a 8 4 3 a 
a a a a 8 5 6 c 5 6 a a c 5 2 a 
a a a a 8 5 5 3 d 5 0 6 9 5 6 a 
a e c 0 6 9 5 4 5 7 a d 4 5 3 a 
8 5 7 a d 4 5 5 5 5 6 9 5 5 0 6 
8 1 3 c 1 3 9 5 5 1 5 4 1 5 6 b 
a a c 3 e a a 9 3 a d 5 6 b 9 2 
8 2 9 6 9 2 8 4 6 8 5 3 d 2 a a 
a 8 2 9 6 e c 5 5 6 9 6 d 0 6 a 
a e c 6 b 9 3 9 7 b a d 1 4 3 a 
a 9 3 9 4 2 8 4 3 a c 3 c 3 a a 
8 6 c 6 d 2 a 9 6 a b c 3 a a a 
8 3 9 1 5 4 6 c 3 c 4 3 c 4 6 a 
a a a 8 5 3 9 5 2 9 5 4 3 9 5 2 
e c 6 c 5 6 c 5 4 4 7 d 4 4 5 6 
