b 9 5 5 5 5 5 7 9 5 5 5 7 9 5 3 
a a d 5 5 5 5 5 2 d 5 5 7 a b a 
a 8 5 5 5 5 5 1 4 5 5 5 7 a a a 
a 8 5 5 5 5 7 c 5 5 3 d 7 a a a 
a a d 1 1 5 5 5 7 b 8 5 3 a a a 
8 2 b a 8 5 5 5 5 2 a b a a a a 
a a a a a b b d 7 a a e 8 2 e a 
a a e a a a 8 1 3 8 4 5 6 c 5 6 
a 8 5 2 a a a c 6 8 1 5 3 9 5 3 
a a b a a a c 5 5 2 a b a a b a 
a a a a e e d 5 5 6 a e a a a a 
8 2 e e d 5 5 5 5 5 4 1 4 2 a a 
a 8 5 5 5 1 5 5 5 7 9 4 7 a a a 
a a d 5 7 a d 5 5 7 a d 7 a a a 
a 8 5 5 7 c 5 5 5 5 4 5 7 a e a 
e c 5 5 5 5 5 7 d 5 5 5 5 4 5 6 
