9 5 1 1 5 5 1 5 1 7 9 5 5 5 5 3 
a b a a b b a d 2 b c 3 d 5 5 6 
a c 2 a a 8 4 3 8 4 1 2 b d 5 3 
8 5 6 a 8 4 3 e a b a a 8 5 5 2 
a 9 5 4 2 b 8 3 8 6 e a a 9 5 2 
e a 9 7 8 2 a a c 1 1 2 a a b a 
9 6 a b a a a c 3 a a a a a a a 
a 9 4 2 e a a 9 2 a a 8 2 a a a 
c 2 b a b a e c 6 e a a a a a a 
b a a a a a d 3 d 5 2 a e 8 2 a 
a c 6 a c 4 5 2 9 1 4 0 1 2 c 2 
a 9 5 4 3 b b a a a b e a a b a 
8 4 5 3 8 2 8 4 2 a a b e a a a 
a 9 3 a a a a d 2 c 4 0 5 6 8 2 
a a e a e c 6 d 0 5 5 4 1 5 6 a 
e c 5 4 5 5 5 5 4 5 5 5 4 5 5 6 
