b 9 5 5 5 5 5 5 5 1 5 5 5 5 5 3 
a 8 5 1 5 1 5 7 9 6 9 5 5 3 d 2 
a 8 5 0 5 0 7 9 4 3 a d 3 e d 2 
a 8 5 0 5 6 9 6 b a 8 5 4 5 5 2 
a 8 5 4 7 9 6 9 2 a a 9 5 3 d 2 
a 8 5 7 9 6 9 6 a e a e b c 5 2 
a c 3 9 4 3 a d 4 3 8 5 4 5 7 a 
8 5 6 8 5 6 a 9 3 c 4 5 5 5 5 2 
8 5 3 8 5 3 a c 4 3 9 5 1 5 7 a 
a 9 6 c 1 6 8 5 3 a a b e b d 2 
a 8 5 7 c 3 c 3 e a a c 1 4 5 6 
a 8 5 1 7 c 3 c 3 a 8 7 c 5 5 3 
a 8 5 0 5 3 c 3 c 6 a d 1 5 5 6 
a 8 5 0 5 2 d 4 1 5 0 7 c 5 5 3 
a 8 5 4 5 4 5 7 c 3 8 5 5 5 5 2 
e c 5 5 5 5 5 5 5 6 c 5 5 5 5 6 
