9 1 1 1 1 1 1 1 1 1 1 1 1 1 1 3 
8 0 0 0 0 0 0 0 0 0 0 0 0 0 0 2 
8 0 0 0 0 0 0 0 0 0 0 0 0 0 0 2 
8 0 0 0 0 0 0 4 4 4 4 4 4 4 4 2 
8 0 0 0 0 2 8 5 5 5 5 5 5 5 5 2 
8 0 0 0 0 2 a d 5 5 3 9 3 9 3 a 
8 0 0 0 0 2 c 5 5 3 a a a a a a 
8 0 0 0 0 0 3 9 3 a a a a a a a 
c 4 4 4 4 4 4 4 6 a a a a a a a 
9 5 5 5 5 3 9 5 5 6 a a a a a a 
a 9 1 1 3 a a d 5 5 4 6 c 6 c 6 
a 8 0 0 2 a c 5 5 5 5 5 5 5 5 3 
a 8 0 0 2 c 5 5 5 5 5 5 5 5 5 6 
a 8 0 0 0 1 1 1 1 1 1 1 1 1 1 3 
a 8 0 0 0 0 0 0 0 0 0 0 0 0 0 2 
e c 4 4 4 4 4 4 4 4 4 4 4 4 4 6 
