9 1 1 1 1 1 1 1 1 1 1 1 1 1 1 3 
8 0 0 0 0 0 0 0 0 0 0 0 0 0 0 2 
8 0 0 0 0 0 0 0 0 0 0 0 0 0 0 2 
8 0 0 0 0 0 0 0 0 0 0 0 0 0 0 2 
c 4 4 4 4 4 4 4 4 4 4 0 0 0 0 2 
9 5 5 5 5 5 5 5 5 5 3 8 0 0 0 2 
a d 1 5 1 3 d 5 5 1 2 8 0 0 0 2 
a 9 4 7 e c 5 1 3 a a 8 0 0 0 2 
a a b d 1 5 3 c 6 c 2 8 0 0 0 2 
a a 8 3 c 3 c 1 5 5 2 8 0 0 0 2 
a a a 8 3 c 3 c 1 7 a 8 0 0 0 2 
a a 8 6 8 1 4 3 8 5 6 8 0 0 0 2 
a a c 3 e 8 7 c 2 d 3 8 0 0 0 2 
a 8 3 8 3 c 3 b c 3 a 8 0 0 0 2 
a a c 6 c 5 4 4 5 6 a 8 0 0 0 2 
e c 5 5 5 5 5 5 5 5 6 c 4 4 4 6 
