9 5 5 5 5 5 5 5 5 5 5 5 1 5 5 3 
8 3 9 5 5 3 9 1 5 5 5 1 0 5 3 a 
a a c 5 3 a a a 9 5 1 2 a 9 6 a 
a a 9 5 6 a a 8 6 9 6 a a a 9 2 
a a a 9 3 c 6 c 1 0 5 2 a c 6 a 
a a a a a 9 5 1 6 c 1 2 8 1 3 a 
c 2 8 4 6 a 9 0 5 1 2 a a a c 2 
9 0 0 5 3 8 6 8 3 a a a a 8 5 2 
a a c 1 6 c 3 c 6 8 6 c 6 c 5 2 
8 2 9 4 1 3 8 5 3 e 9 1 1 3 9 2 
a c 6 9 6 a c 5 6 9 6 a a c 2 a 
c 1 1 6 9 4 5 5 1 4 5 0 4 3 c 2 
9 2 8 5 4 5 5 1 4 1 1 0 1 0 1 2 
a 8 4 5 1 5 1 4 3 a a a a a a a 
8 0 5 1 4 1 4 5 0 0 0 0 0 0 0 2 
e c 5 4 5 4 5 5 6 e e e e e e e 
